sub-	亜	ア, つ-ぐ	под-
pathetic	哀	アイ, あわ-れ, あわ-れむ, かな-しい	печаль
push open	挨	アイ	приветствие
love	愛	アイ, いと-しい, め-でる, お-しむ, まな	любовь
not clear	曖	アイ	двусмысленный
bad	悪	アク, オ, わる-い, わる-, あ-し, にく-い, にく-む	плохой
grip	握	アク、にぎ-る	держать
pressure	圧	アツ, お-す, へ-す	давление
handle	扱	あつか-う, こ-く	обращаться
allocate	宛	エン, あ-てる,  -づつ, あたか-も	адрес
storm	嵐	ラン, あらし	буря
cheap	安	アン, やす-い, やす-まる, やす, やす-らか	дешёвый
plan	案	アン, つくえ	проект
dark	暗	アン、くら-い, くら-む	тёмный
by means of	以	イ, もっ-て	префикс направления
clothes	衣	イ、ころも, きぬ, -ぎ	одежда
rank	位	イ、くらい	ранг
surround	囲	イ、かこ-む、かこ-う	окружать
medicine	医	イ, くすし	врач
reliant	依	イ, エ, よ-る	зависеть
committee	委	イ、ゆだ-ねる	поручать
intimidate	威	イ, おど-す,  おど-かす	авторитет
do	為	イ, ため, な-る, な-す, す-る, たり, つく-る, なり	делать
fear	畏	イ, おそ-れる, かしこ-まる	повиноваться
stomach	胃	イ	желудок
military officer	尉	イ	младший офицер
uncommon	異	イ, こと, こと-なる, け	отличаться
shift	移	イ、うつ-る、うつ-す	перемещаться
wither	萎	イ, な, しお-れる, しな-びる, しぼ-む, な-える	вянуть
admirable	偉	イ、えら-い	великий
chair	椅	イ	стул
samekind	彙	イ	словарь
idea	意	イ	мысль
differ	違	イ, ちが-う, ちが-える, たが-う, たが-える	отличаться
fiber	維	イ	поддержка
consolation	慰	イ、なぐさ-める、なぐさ-む	утешать
bequeath	遺	イ, ユイ, のこ-す	оставлять после себя
horizontal	緯	イ, よこいと, ぬき	широта
range	域	イキ	район
nurture	育	イク、そだ-つ、そだ-てる、はぐく-む	воспитывать
one	一	イチ、イツ、ひと、ひと-つ	один
one (Falsification prevention)	壱	イチ	один
deviate	逸	イツ, そ-れる, そ-らす, はぐ-れる	отклоняться
thorn	茨	（いばら）	терновник
potato	芋	いも	батат
pull	引	イン、ひ-く、ひ-ける	тянуть
mark	印	イン、しるし, しる-す	печать
cause	因	イン, よ-る, ちな-む	причина
throat	咽	イン, むせ-ぶ, むせ-る, のど	захлёбываться
matrimony	姻	イン	брачное родство
member	員	イン	персонал
institution	院	イン	учреждение
lewdness	淫	イン、みだ-ら	разврат
shade	陰	イン、かげ、かげ-る	тень
drink	飲	イン、の-む	пить
conceal	隠	イン、かく-す、かく-れる	прятать
rhyme	韻	イン	рифма
right (direction)	右	ウ、ユウ、みぎ	правый
eaves	宇	ウ	вселенная
feather	羽	ウ, は, わ, はね	перья
rain	雨	ウ、あめ、（あま）, -さめ	дождь
songs with samisen	唄	バイ, うた, うた-う	песня
gloom	鬱	ウツ, ふさ-ぐ	меланхолия
furrow	畝	ホ, うね, せ	грядка
bay	浦	ホ, うら	бухта
carry	運	ウン、はこ-ぶ	судьба
cloud	雲	ウン、くも	туча
eternity	永	エイ、なが-い	вечный
swim	泳	エイ、およ-ぐ	плавать
England	英	エイ, はなぶさ	венчик
reflect	映	エイ、うつ-る、うつ-す、は-える	отражаться
prosperity	栄	エイ、さか-える、は-え、は-える	расцвет
manage	営	エイ、いとな-む	бизнес
recitation	詠	エイ, よ-む, うた-う	стихосложение
shadow	影	エイ、かげ	силуэт
pointed	鋭	エイ、するど-い	острый
defense	衛	エイ, エ	охранять
easy	易	エキ, イ, やさ-しい, やす-い	лёгкий
epidemic	疫	エキ、（ヤク）	эпидемия
benefit	益	エキ、（ヤク）, ま-す	польза
fluid	液	エキ	жидкость
station	駅	エキ	станция
ecstasy	悦	エツ, よろこ-ぶ, よろこ-ばす	восторг
crossover	越	エツ、こ-す、こ-える	пересекать
audience	謁	エツ	аудиенция
review	閲	エツ, けみ-する	просматривать
round, yen	円	エン, まる-い, まる, まろ-やか, まど, まど-か	иена
prolong	延	エン、の-びる、の-べる、の-ばす	растягивать
run alongside	沿	エン、そ-う	вдоль
inflammation	炎	エン、ほのお	пламя
grudge	怨	エン、オン, うら-む, うらみ, うら-めしい	злоба
banquet	宴	エン, うたげ	банкет
princess	媛	エン, ひめ	барышня
aid	援	エン	помощь
garden	園	エン、その	сад
smoke	煙	エン、けむ-る、けむり、けむ-い	дым
monkey	猿	エン、さる	обезьяна
far	遠	エン、（オン）、とお-い	далёкий
lead	鉛	エン、なまり	свинец
salt	塩	エン、しお	соль
perform	演	エン	исполнять
affinity	縁	エン、ふち, ふちど-る, ゆかり, よすが, へり, えにし	узы
glossy	艶	エン, つや, なま-めかしい, なま-めく, あで-やか, つや-めく	очарование
dirty	汚	オ、けが-す、けが-れる、けが-らわしい、よご-す、よご-れる、きたな-い	грязь
king	王	オウ, -ノウ	монарх
concave	凹	オウ, くぼ-む, へこ-む, ぼこ	вогнутый
center	央	オウ	центр
respond	応	オウ、こた-える	реагирование
outward journey	往	オウ, い-く, ゆ-く	направляться
push	押	オウ、お-す、お-さえる	надавливать
flourishing	旺	オウ	названия компаний
Europe	欧	オウ	Европа
assault	殴	オウ、なぐ-る	бить
cherrytree	桜	オウ、さくら	вишня
venerable old man	翁	オウ, おきな	старец
heart	奥	オウ、おく, おく-まる	глубь
side	横	オウ、よこ	горизонтальный
hill	岡	コウ, おか	холм
roof	屋	オク、や	здание
hundred million	億	オク	сто миллионов
recollection	憶	オク	память
timidity	臆	オク	робкий
uneasiness	虞	グ,おそれ	опасения
thelatter	乙	オツ, イツ, おと-, きのと	второй
I, we	俺	おれ	я
wholesale	卸	おろ-す、おろし	оптовый
sound	音	オン、イン、おと、ね	звук
grace	恩	オン	признательность
warm	温	オン, あたた-か, あたた-かい, あたた-まる, あたた-める, ぬく	тёплый
calm	穏	オン、おだ-やか	умеренный
below	下	カ、ゲ、した、しも、もと、さ-げる、さ-がる、くだ-る、くだ-す、くだ-さる、お-ろす、お-りる	низ
change	化	カ、ケ、ば-ける、ば-かす	превращаться
fire	火	カ、ひ、（ほ）	огонь
add	加	カ、くわ-える、くわ-わる	добавлять
possible	可	カ, -べ-き, -べ-し	одобрять
temporary	仮	カ、（ケ）、かり	временный
what	何	カ、なに、（なん）	что
flower	花	カ、はな	цветок
excellent	佳	カ	прекрасный
value	価	カ、あたい	цена
fruit	果	カ、は-たす、は-てる、は-て	плод
river	河	カ、かわ	река
torment	苛	カ, いじ-める, さいな-む, いらだ-つ	мучить
section	科	カ	отделение
rack	架	カ、か-ける、か-かる	подставка
summer	夏	カ、（ゲ）、なつ	лето
house	家	カ, ケ, いえ, や, うち	дом
luggage	荷	カ、に	ноша
splendor	華	カ、（ケ）、はな	пышный
confectionery	菓	カ	сласти
freight	貨	カ, たから	монета
whirlpool	渦	カ、うず	водоворот
go beyond	過	カ、す-ぎる、す-ごす、あやま-つ、あやま-ち, よ-ぎる	превышать
marry into	嫁	カ、よめ、とつ-ぐ	невеста
sparetime	暇	カ, ひま, いとま	досуг
calamity	禍	カ, わざわい	бедствие
shoes	靴	カ、くつ	обувь
widow	寡	カ	мало
song	歌	カ、うた、うた-う	песня
counters for things	箇	カ, コ	штука
earnings	稼	カ、かせ-ぐ	зарабатывать
section	課	カ	отдел
mosquito	蚊	か	комар
tusk	牙	ガ、（ゲ）、きば	клык
tile	瓦	ガ, かわら	черепица
ego	我	ガ、われ、わ	эго
tableau	画	ガ、カク, えが-く	картина
bud	芽	ガ、め	бутон
congratulations	賀	ガ	поздравление
gracious	雅	ガ, みや-び	изящный
starve	餓	ガ, う-える	голод
jammed in	介	カイ	посредничать
times	回	カイ、（エ）、まわ-る、まわ-す, もとお-る	вращаться
ashes	灰	カイ、はい	пепел
association	会	カイ、エ、あ-う	встреча
cheerful	快	カイ、こころよ-い	приятный
commandment	戒	カイ、いまし-める	предостерегать
reformation	改	カイ、あらた-める、あらた-まる	изменять
suspicious	怪	カイ、あや-しい、あや-しむ	загадочный
kidnap	拐	カイ	похищать
repent	悔	カイ、く-いる、く-やむ、くや-しい	раскаиваться
sea	海	カイ、うみ	море
world	界	カイ	сфера
all	皆	カイ, みな, みんな	все
contraption	械	カイ	механизм
picture	絵	カイ、エ	картина
open	開	カイ、ひら-く、ひら-ける、あ-く、あ-ける	открывать
floor of a building	階	カイ, きざはし	этаж
clod	塊	カイ、かたまり, つちくれ	кусок
square character style	楷	カイ	уставной стиль
untie	解	カイ, ゲ, と-く, と-かす, と-ける, ほど-く, ほど-ける, わか-る	развязывать
crush	潰	カイ、つぶ-す、つぶ-れる, つい-える	крушить
demolition	壊	カイ、こわ-す、こわ-れる	разрушать
pocket	懐	カイ、ふところ、なつ-かしい、なつ-かしむ、なつ-く、なつ-ける, なず-ける, いだ-く, おも-う	ностальгия
harmony	諧	カイ	благозвучие
shellfish	貝	バイ, かい	раковина
outside	外	ガイ、ゲ、そと、ほか、はず-す、はず-れる	вне
censure	劾	ガイ	обвинять
harm	害	ガイ	вред
cliff	崖	ガイ、がけ	утёс
horizon	涯	ガイ, はて	предел
street	街	ガイ、（カイ）、まち	улица
rue	慨	ガイ	скорбеть
cover	蓋	ガイ、ふた, けだ-し	крышка
above-stated	該	ガイ	вышеупомянутый
outline	概	ガイ, おうむ-ね	в общем
dead remains	骸	ガイ, カイ, むくろ	останки
hedge	垣	エン, かき	ограда
persimmon	柿	シ, かき, こけら	хурма
each	各	カク、おのおの	каждый
angle	角	カク、かど、つの	угол
broaden	拡	カク, ひろ-がる, ひろ-げる	расширять
leather	革	カク、かわ	кожа
status	格	カク、（コウ）	разряд
nucleus	核	カク	ядро
husk	殻	カク、から	скорлупа
enclosure	郭	カク, くるわ	ограждённая площадь
memorize	覚	カク、おぼ-える、さ-ます、さ-める	ощущение
contrast	較	カク, くら-べる	сравнивать
isolate	隔	カク、へだ-てる、へだ-たる	разделять
tall	閣	カク	высокое здание
certain	確	カク、たし-か、たし-かめる	определённый
seize	獲	カク、え-る	добыча
menacing	嚇	カク, おど-かす	угроза
harvest	穫	カク	урожай
study	学	ガク、まな-ぶ	учиться
point	岳	ガク、たけ	пик
pleasure	楽	ガク、ラク、たの-しい、たの-しむ	удовольствие
amount	額	ガク、ひたい	сумма
jaw	顎	ガク、あご	челюсть
hang	掛	か-ける、か-かる、かかり	вешать
lagoon	潟	セキ, かた	лагуна
fasten	括	カツ, くく-る	охватывать
active	活	カツ, い-きる, い-かす, い-ける	живой
hoarse	喝	カツ	орать
thirst	渇	カツ、かわ-く	жажда
divide	割	カツ、わ-る、わり、わ-れる、さ-く	разделять
arrowroot	葛	カツ, カチ, つづら, くず	пуэрария
slippery	滑	カツ、コツ、すべ-る、なめ-らか	скользить
brown	褐	カツ	коричневый
control	轄	カツ, くさび	юрисдикция
moreover	且	か-つ	кроме того
stocks	株	シュ, かぶ	акция
kettle	釜	フ, かま	котелок
sickle	鎌	レン, ケン, かま	серп
reap	刈	ガイ, カイ, か-る	косить
dry	干	カン、ほ-す、ひ-る	сухой
publish	刊	カン	издавать
sweet	甘	カン, あま-い, あま-える, あま-やかす, うま-い	сладкий
sweat	汗	カン、あせ	пот
tincan	缶	カン, かま	консервная банка
perfect	完	カン	завершение
liver	肝	カン、きも	печень
government official	官	カン	чиновник
crown	冠	カン、かんむり	корона
scroll	巻	カン, ケン、ま-く、まき	свиток
watchover	看	カン, み-る	присматривать
collapse	陥	カン、おちい-る、おとしい-れる	впадать
dry	乾	カン, ケン, かわ-く, かわ-かす, ほ-す, ひ-る, いぬい	сухой
intuition	勘	カン	разбираться
afflicted	患	カン、わずら-う	больной
pierce	貫	カン、つらぬ-く	пронзать
cold	寒	カン、さむ-い	холод
yell	喚	カン, わめ-く	вопить
withstand	堪	カン, タン, た-える, たま-る, こ-らえる, こた-える	терпеть
interchange	換	カン、か-える、か-わる	обменивать
daring	敢	カン, あ-えて, あ-えない, あ-えず	решительный
coffin	棺	カン	гроб
goodwill	款	カン	параграф
interval	間	カン, ケン, あいだ, ま, あい	интервал
leisure	閑	カン	досуг
persuade	勧	カン、すす-める	советовать
tolerant	寛	カン, くつろ-ぐ, ひろ-い	великодушие
tree-trunk	幹	カン、みき	ствол
feeling	感	カン	чувство
China	漢	カン	китайский
accustomed	慣	カン、な-れる、な-らす	обыкновение
pipe	管	カン、くだ	труба
related	関	カン、せき、かか-わる、からくり	застава
delight	歓	カン, よろこ-ぶ	радость
oversee	監	カン	надзирать
slacken	緩	カン、ゆる-い、ゆる-やか、ゆる-む、ゆる-める	ослаблять
remorse	憾	カン, うら-む	сожалеть
sendback	還	カン, かえ-る	возвращать
public building	館	カン, やかた, たて	здание
ring	環	カン, わ	кольцо
simplicity	簡	カン	простой
observe	観	カン, み-る	осматривать
Korea	韓	カン	Южная Корея
warship	艦	カン	военный корабль
specimen	鑑	カン, かんが-みる, かがみ	оценивать
circle	丸	ガン、まる、まる-い、まる-める	круглый
include	含	ガン、ふく-む、ふく-める	содержать
beach	岸	ガン、きし	берег
boulder	岩	ガン、いわ	скала
trifle with	玩	ガン, もちあそ-ぶ	игрушка
eyeball	眼	ガン、（ゲン）、まなこ, め	глаз
stubborn	頑	ガン, かたく	упорный
face	顔	ガン、かお	лицо
request	願	ガン、ねが-う	просьба
plan	企	キ, くわだ-てる, たくら-む	замысел
deed	伎	ギ, キ, わざ	кабуки
dangerous	危	キ、あぶ-ない、あや-うい、あや-ぶむ	опасный
desk	机	キ、つくえ	стол
feeling	気	キ、ケ	дух
branch off	岐	キ	разветвляться
hope	希	キ, ケ, まれ	редкий
mourning	忌	キ、い-む、い-まわしい	воздерживаться
steam	汽	キ	пар
strange	奇	キ, く-しき	необыкновенный
pray	祈	キ、いの-る	молитва
seasons	季	キ	сезон
chronicle	紀	キ	эра
rut	軌	キ	колея
previously	既	キ、すで-に	уже
write down	記	キ、しる-す	записывать
wake up	起	キ、お-きる、お-こる、お-こす	вставать
hungry	飢	キ、う-える	голод
ghost	鬼	キ、おに	чёрт
return	帰	キ、かえ-る、かえ-す	возвращаться
foundation	基	キ、もと、もとい	основа
approach	寄	キ、よ-る、よ-せる	подходить
rule	規	キ	правило
turtle	亀	キ、かめ	черепаха
rejoice	喜	キ、よろこ-ぶ	радость
how many	幾	キ、いく	сколько
brandish	揮	キ, ふる-う	размахивать
period of time	期	キ、（ゴ）	срок
chess piece	棋	キ, ご	шахматы
precious	貴	キ、たっと-い、とうと-い、たっと-ぶ、とうと-ぶ	благородный
abandon	棄	キ, す-てる	отбрасывать
destroy	毀	キ, こぼ-つ, こわ-す, こわ-れる, こぼ-れる	портить
national flag	旗	キ、はた	флаг
container	器	キ、うつわ	сосуд
capital	畿	キ	столичная область
radiance	輝	キ、かがや-く	сверкать
machine	機	キ、はた	механизм
equestrian	騎	キ	всадник
skill	技	ギ、わざ	мастерство
best regards	宜	ギ, よろ-しい	благоприятный
falsehood	偽	ギ、いつわ-る、にせ	ложный
deceit	欺	ギ、あざむ-く	обман
righteousness	義	ギ	честь
doubt	疑	ギ、うたが-う	подозрение
ceremony	儀	ギ	церемония
frolic	戯	ギ、たわむ-れる, ざ-れる, じゃ-れる	забава
mimic	擬	ギ, まが-い, もど-き	имитация
sacrifice	犠	ギ, いけにえ	жертва
deliberation	議	ギ	обсуждение
chrysanthemum	菊	キク	хризантема
goodluck	吉	キチ、キツ, よし	удача
consume	喫	キツ	закусывать
packed	詰	キツ、つ-める、つ-まる、つ-む	набивать
instead	却	キャク, かえ-って, しりぞ-ける	убирать
guest	客	キャク、カク	гость
leg	脚	キャク、（キャ）、あし	ножка
inverted	逆	ギャク、さか, さか-さ、さか-らう	наоборот
tyrannize	虐	ギャク、しいた-げる	тиранить
nine	九	キュウ、ク、ここの、ここの-つ	девять
long time	久	キュウ、（ク）、ひさ-しい	долгий
reach out	及	キュウ、およ-ぶ、およ-び、およ-ぼす	достигать
bow (archery, violin)	弓	キュウ、ゆみ	лук
hill	丘	キュウ、おか	холм
old times	旧	キュウ, ふる-い, もと	прежний
rest	休	キュウ、やす-む、やす-まる、やす-める	отдых
suck	吸	キュウ、す-う	сосать
decay	朽	キュウ、く-ちる	гнить
mortar	臼	キュウ、うす, うすづ-く	ступа
request	求	キュウ、もと-める	требовать
research	究	キュウ、きわ-める	осваивать
cry	泣	キュウ、な-く	плакать
hurry	急	キュウ、いそ-ぐ	спешить
rank	級	キュウ	разряд
twist	糾	キュウ, ただ-す	разузнавать
Shinto shrine	宮	キュウ、グウ、（ク）、みや	дворец
salvation	救	キュウ、すく-う	спасать
sphere	球	キュウ、たま	мяч
salary	給	キュウ, たま-う	снабжать
smell	嗅	キュウ、か-ぐ	нюхать
hardup	窮	キュウ,  きわ-める, きわ-まる, きわ-み	тяжёлое положение
cow	牛	ギュウ、うし	корова
leave	去	キョ、コ、さ-る	уходить
gigantic	巨	キョ	огромный
reside	居	キョ、い-る, お-る	проживать
repel	拒	キョ、こば-む	отказываться
foothold	拠	キョ, コ, よ-る	основываться
raise	挙	キョ, あ-げる, あ-がる	поднимать
void	虚	キョ, むな-しい, うつ-ろ	пустота
permit	許	キョ, ゆる-す, もと	разрешать
long-distance	距	キョ, へだ-たる, けづめ	расстояние
fish	魚	ギョ、うお、さかな	рыба
honorable	御	ギョ, ゴ, おん-, お-, み-	гонорифические префиксы
fishing	漁	ギョ, リョウ, あさ-る	рыболовство
villain	凶	キョウ	несчастье
together	共	キョウ、とも	совместный
shout	叫	キョウ、さけ-ぶ	крик
lunatic	狂	キョウ、くる-う、くる-おしい	сумасшедший
capital	京	キョウ, ケイ, キン, みやこ	столичный город
receive	享	キョウ, う-ける	получать
offer	供	キョウ、（ク）、そな-える、とも	предоставлять
cooperation	協	キョウ	сотрудничество
condition	況	キョウ, まし-て, いわ-んや	положение
gorge	峡	キョウ, はざま	ущелье
pinch	挟	キョウ、はさ-む、はさ-まる, さしはさ-む	зажимать
cramped	狭	キョウ、せま-い、せば-める、せば-まる	узкий
fear	恐	キョウ, おそ-れる, おそ-る, おそ-ろしい, こわ-い, こわ-がる	страх
respect	恭	キョウ、うやうや-しい	почтительный
bosom	胸	キョウ、むね、（むな）	грудь
threaten	脅	キョウ、おびや-かす、おど-す、おど-かす	угрожать
strong	強	キョウ, ゴウ, つよ-い, つよ-まる, つよ-める, し-いる, こわ-い	сильный
teach	教	キョウ、おし-える、おそ-わる	учить
hometown	郷	キョウ、ゴウ, さと	родина
boundary	境	キョウ、（ケイ）、さかい	граница
bridge	橋	キョウ、はし	мост
rectify	矯	キョウ、た-める	выпрямлять
mirror	鏡	キョウ、かがみ	зеркало
compete	競	キョウ、ケイ、きそ-う、せ-る	состязаться
echo	響	キョウ、ひび-く	эхо
wonder	驚	キョウ、おどろ-く、おどろ-かす	изумляться
face-up	仰	ギョウ、（コウ）、あお-ぐ、おお-せ, お-っしゃる, おっしゃ-る	смотреть вверх
daybreak	暁	ギョウ、あかつき	рассвет
business	業	ギョウ、ゴウ、わざ	промышленность
congeal	凝	ギョウ, こ-る, こ-らす, こご-らす, こご-らせる, こご-る	застывать
musical composition	曲	キョク, ま-がる, ま-げる, くま	мелодия
office	局	キョク, つぼね	бюро
poles	極	キョク、ゴク、きわ-める、きわ-まる、きわ-み, き-める, き-まる	полюс
ball	玉	ギョク、たま	драгоценный камень
towel	巾	キン	тряпка
axe	斤	キン	катти
level	均	キン, なら-す	равнять
near	近	キン、ちか-い	близкий
gold	金	キン、コン、かね、（かな）	золото
germ	菌	キン	микроб
diligence	勤	キン、（ゴン）、つと-める、つと-まる, いそ-しむ	служба
harp	琴	キン、こと	гуцинь
muscle	筋	キン、すじ	мышца
aweebit	僅	キン、わず-か	всего лишь
prohibition	禁	キン	запрет
tense	緊	キン, し-める, し-まる	срочный
brocade	錦	キン、にしき	парча
discreet	謹	キン、つつし-む	почтительно
collar	襟	キン、えり	воротник
versify	吟	ギン	читать нараспев
silver	銀	ギン, しろがね	серебро
ward	区	ク	район города
phrase	句	ク	фраза
suffer	苦	ク、くる-しい、くる-しむ、くる-しめる、にが-い、にが-る	горький
drive	駆	ク、か-ける、か-る	гнать
tool	具	グ, そな-える, つぶさ-に	принадлежности
dread	惧	グ, おそ-れる	опасение
foolish	愚	グ、おろ-か	глупый
sky	空	クウ、そら、から,  あ-く、あ-ける、す-く, す-かす, むな-しい	пустота
accidentally	偶	グウ, たま	чётный
interview	遇	グウ, あ-う	обращение
corner	隅	グウ、すみ	угол
skewer	串	くし	вертел
yield	屈	クツ, かが-む, かが-める	гнуться
dig	掘	クツ、ほ-る	копать
cavern	窟	クツ, コツ, いわや, いはや, あな	пещера
bear	熊	くま	медведь
winding	繰	ソウ, く-る	наматывать
you	君	クン、きみ	ты
instruction	訓	クン, おし-える, よ-む	наставление
meritorious deed	勲	クン, いさお	орден
fragrant	薫	クン、かお-る	благоухать
army	軍	グン	армия
county	郡	グン	уезд
flock	群	グン, む-れる, む-れ, むら, むら-がる	группа
older brother	兄	ケイ、（キョウ）、あに	старший брат
punish	刑	ケイ	кара
shape	形	ケイ、ギョウ、かた、かたち, なり	форма
lineage	系	ケイ	система
diameter	径	ケイ	диаметр
stalk	茎	ケイ、くき	стебель
person in charge	係	ケイ、かか-る、かかり, かか-わる	ответственный
model	型	ケイ、かた	тип
pledge	契	ケイ、ちぎ-る	обещание
measure	計	ケイ、はか-る、はか-らう	измерять
favor	恵	ケイ、エ、めぐ-む	благодеяние
disclose	啓	ケイ, ひら-く	просвещать
put up (a notice)	掲	ケイ、かか-げる	поднимать
mountain stream	渓	ケイ, たに	ущелье
manage	経	ケイ、キョウ、へ-る, た-つ	проходить
lightning-bug	蛍	ケイ、ほたる	светлячок
respect	敬	ケイ、うやま-う	уважать
scenery	景	ケイ	пейзаж
light	軽	ケイ, かる-い, かろ-やか, かろ-んじる	лёгкий
lean	傾	ケイ, かたむ-く, かたむ-ける, かたぶ-く, かた-げる, かし-げる	наклон
portable	携	ケイ、たずさ-える、たずさ-わる	иметь при себе
inherit	継	ケイ, つ-ぐ, まま-	следовать
visit a temple	詣	ケイ、もう-でる, まい-る	паломничество
jubilation	慶	ケイ, よろこ-び	поздравлять
long for	憬	ケイ, あこが-れる	жаждать
consider	稽	ケイ, かんが-える	думать
recess	憩	ケイ、いこ-い、いこ-う	передышка
guard against	警	ケイ, いまし-める	полиция
chicken	鶏	ケイ, にわとり, とり	курица
art	芸	ゲイ	искусство
welcome	迎	ゲイ、むか-える	выходить навстречу
whale	鯨	ゲイ、くじら	кит
fissure	隙	ゲキ、すき	щель
drama	劇	ゲキ	театр
beat	撃	ゲキ、う-つ	нападать
violent	激	ゲキ、はげ-しい	яростный
beam	桁	けた	брус
lack	欠	ケツ、か-ける、か-く	недостача
hole	穴	ケツ、あな	дыра
blood	血	ケツ、ち	кровь
decide	決	ケツ、き-める、き-まる	решать
tie	結	ケツ、むす-ぶ、ゆ-う、ゆ-わえる	узел
greatness	傑	ケツ, すぐ-れる	выдающийся
undefiled	潔	ケツ、いさぎよ-い	чистота
month, moon	月	ゲツ、ガツ、つき	месяц
dog	犬	ケン、いぬ	собака
affair	件	ケン, くだん	происшествие
see	見	ケン、み-る、み-える、み-せる	видеть
ticket	券	ケン	билет
shoulder	肩	ケン、かた	плечо
build	建	ケン、（コン）、た-てる、た-つ	строить
sharpen	研	ケン、と-ぐ	точить
prefecture	県	ケン	префектура
frugal	倹	ケン, つま-しい	бережливый
concurrently	兼	ケン、か-ねる	одновременно
sabre	剣	ケン、つるぎ	меч
fist	拳	ケン、こぶし	кулак
flats	軒	ケン、のき	свес крыши
healthy	健	ケン、すこ-やか	здоровый
precipitous	険	ケン、けわ-しい	обрывистый
sphere	圏	ケン	сфера
strict	堅	ケン、かた-い	твёрдый
examine	検	ケン	расследовать
dislike	嫌	ケン、（ゲン）、きら-う、いや	нелюбовь
offering	献	ケン、（コン）	пожертвование
silk	絹	ケン、きぬ	шёлк
dispatch	遣	ケン, つか-う, つか-わす, や-る	отправлять
rights	権	ケン、（ゴン）	права
constitution	憲	ケン	конституция
intelligent	賢	ケン、かしこ-い	мудрость
self-effacing	謙	ケン	скромность
key	鍵	ケン、かぎ	ключ
cocoon	繭	ケン, まゆ, きぬ	кокон
appear	顕	ケン, あらわ-れる	выявлять
test	験	ケン、（ゲン）, しるし, ため-す	испытывать
suspend	懸	ケン、（ケ）、か-ける、か-かる	висеть
origin	元	ゲン、ガン、もと	начало
phantasm	幻	ゲン、まぼろし	призрак
mysterious	玄	ゲン	непостижимый
say	言	ゲン、ゴン、い-う、こと	слово
bowstring	弦	ゲン、つる	тетива
limit	限	ゲン、かぎ-る	предел
field	原	ゲン、はら	равнина
appear	現	ゲン, あらわ-れる, あらわ-す, うつつ, うつ-つ	действительный
gunwale	舷	ゲン	борт судна
decrease	減	ゲン、へ-る、へ-らす	уменьшаться
origin	源	ゲン、みなもと	исток
strict	厳	ゲン、（ゴン）、おごそ-か、きび-しい, いか-めしい	строгий
self	己	コ、キ、おのれ, つちのと	сам
door	戸	コ、と	дверь
old	古	コ、ふる-い、ふる-す	старый
call	呼	コ、よ-ぶ	звать
hard	固	コ、かた-める、かた-まる、かた-い	твёрдый
crotch	股	コ, また, もも	бедро
tiger	虎	コ、とら	тигр
orphan	孤	コ	сирота
arc	弧	コ	дуга
circumstances	故	コ, ゆえ, ふる-い, もと	происшествие
wither	枯	コ、か-れる、か-らす	засыхать
individual	個	コ, カ	индивидуальный
warehouse	庫	コ、（ク）, くら	склад
lake	湖	コ、みずうみ	озеро
employ	雇	コ、やと-う	наём
boast	誇	コ、ほこ-る	гордость
drum	鼓	コ、つづみ	барабан
tie up	錮	コ	тюремное заключение
look back	顧	コ、かえり-みる	оглядываться
five	五	ゴ、いつ、いつ-つ	пять
mutually	互	ゴ, たが-い, かたみ-に	взаимный
noon	午	ゴ, うま	полдень
give	呉	ゴ, く-れる	делать для кого-л.
behind	後	ゴ、コウ、のち、うし-ろ、あと、おく-れる	после
recreation	娯	ゴ	веселиться
enlightenment	悟	ゴ、さと-る	просветление
Go	碁	ゴ	игра го
language	語	ゴ、かた-る、かた-らう	язык
mistake	誤	ゴ、あやま-る	ошибка
safeguard	護	ゴ, まも-る	защищать
mouth	口	コウ、ク、くち	рот
craft	工	コウ、ク	техника
public	公	コウ、おおやけ	общественный
capture	勾	コウ	похищать
cavity	孔	コウ, あな	отверстие
achievement	功	コウ、（ク）, いさお	заслуга
adroit	巧	コウ, たく-み, たく-む, うま-い	мастерство
wide	広	コウ、ひろ-い、ひろ-まる、ひろ-める、ひろ-がる、ひろ-げる	широкий
armor	甲	コウ、カン, きのえ	панцирь
mix	交	コウ、まじ-わる、まじ-える、ま-じる、ま-ざる、ま-ぜる、か-う、か-わす, こもごも	пересекаться
ray	光	コウ、ひか-る、ひかり	сиять
overt here	向	コウ、む-く、む-ける、む-かう、む-こう	направленность
empress	后	コウ, ゴ, きさき	императрица
like	好	コウ, この-む, す-く, よ-い, い-い	нравиться
inlet	江	コウ、え	китайская река
think	考	コウ、かんが-える	думать
go	行	コウ、ギョウ、（アン）、い-く、ゆ-く、おこな-う	идти
pit	坑	コウ	шахта
filial piety	孝	コウ	сыновний долг
confront	抗	コウ, あらが-う	анти-
aggression	攻	コウ、せ-める	наступать
grow late	更	コウ、さら、ふ-ける、ふ-かす	обновлять
effect	効	コウ、き-く	эффект
happiness	幸	コウ、さいわ-い、さち、しあわ-せ	счастье
arrest	拘	コウ, かか-わる	несмотря
agreement	肯	コウ, がえん-ずる	соглашаться
marquis	侯	コウ	маркиз
thick	厚	コウ、あつ-い	толстый
constancy	恒	コウ, つね	постоянный
deluge	洪	コウ	наводнение
emperor	皇	コウ、オウ	император
deepred	紅	コウ、（ク）、べに、くれない, あか-い	алый
laid waste	荒	コウ, あら-い, あら-, あ-れる, あ-らす, すさ-む	бурный
outskirts	郊	コウ	пригород
incense	香	コウ、（キョウ）、か、かお-り、かお-る	аромат
climate	候	コウ、そうろう	погода
school	校	コウ	школа
till	耕	コウ、たがや-す	земледелие
cruise	航	コウ	курсировать
tribute	貢	コウ、（ク）、みつ-ぐ	дань
descend	降	コウ, ゴ, お-りる, お-ろす, ふ-る, ふ-り, くだ-る, くだ-す	спускаться
tall, expensive	高	コウ、たか-い、たか、たか-まる、たか-める	высокий
health	康	コウ	здоровье
withdraw	控	コウ、ひか-える	записи
close up	梗	コウ, むね	закупорка
yellow	黄	コウ、オウ、き、（こ）	жёлтый
throat	喉	コウ、のど	горло
disconcerted	慌	コウ、あわ-てる、あわ-ただしい	паника
harbor	港	コウ、みなと	порт
stiff	硬	コウ、かた-い	жёсткий
strangle	絞	コウ、しぼ-る、し-める、し-まる	душить
paragraph	項	コウ, うなじ	параграф
gutter	溝	コウ、みぞ	канава
mineral	鉱	コウ, あらがね	руда
construct	構	コウ、かま-える、かま-う	структура
hawser	綱	コウ、つな	канат
fermentation	酵	コウ	дрожжи
draft	稿	コウ	рукопись
entertain	興	コウ、キョウ、おこ-る、おこ-す	развлечение
equilibrium	衡	コウ	равновесие
steel	鋼	コウ、はがね	сталь
lecture	講	コウ	лекция
subscription	購	コウ	приобретать
beg	乞	コツ, こ-う	выпрашивать
number	号	ゴウ	номер
fit	合	ゴウ、ガッ、（カッ）、あ-う、あ-わす、あ-わせる	соединяться
torture	拷	ゴウ	пытать
sturdy	剛	ゴウ	жёсткий
be proud	傲	ゴウ, おご-る	высокомерие
overpowering	豪	ゴウ, えら-い	превосходящий
overcome	克	コク, か-つ	преодолевать
tell	告	コク、つ-げる	объявлять
valley	谷	コク、たに	долина
engrave	刻	コク、きざ-む	гравировать
country	国	コク、くに	страна
black	黒	コク, くろ, くろ-ずむ, くろ-い	чёрный
cereals	穀	コク	зерно
cruel	酷	コク, ひど-い	жестокий
prison	獄	ゴク	тюрьма
bone	骨	コツ、ほね	кость
horse	駒	こま	пешка
crowded	込	こ-む、こ-める	внутрь
times	頃	ケイ, ころ	около
now	今	コン、キン、いま	сейчас
become distressed	困	コン、こま-る	трудности
descendants	昆	コン	насекомое
rancor	恨	コン、うら-む、うら-めしい	обида
root	根	コン、ね	корень
marriage	婚	コン	брак
mix	混	コン、ま-じる、ま-ざる、ま-ぜる、こ-む	смешивать
mark	痕	コン、あと	шрам
dark blue	紺	コン	тёмно-синий
soul	魂	コン, たましい, たま	душа
ground-breaking	墾	コン	расчистка
sociable	懇	コン、ねんご-ろ	любезный
left (direction)	左	サ、ひだり	левый
help	佐	サ	старший офицер
sand	沙	サ	песок
investigate	査	サ	расследовать
sand	砂	サ、シャ、すな	песок
tempt	唆	サ, そそ-る, そそのか-す	будоражить
distinction	差	サ、さ-す	разница
lie	詐	サ, いつわ-る	лгать
chain	鎖	サ, くさり, とざ-す	цепь
sit	座	ザ、すわ-る	сидение
sprain	挫	ザ, サ, くじ-く, くじ-ける	вывихнуть
genius	才	サイ	талант
again	再	サイ、（サ）、ふたた-び	вторично
disaster	災	サイ、わざわ-い	бедствие
wife	妻	サイ、つま	жена
form	采	サイ	игральная кость
smash	砕	サイ、くだ-く、くだ-ける	раздроблять
superintend	宰	サイ	руководить
plantation	栽	サイ	выращивать
coloring	彩	サイ、いろど-る	расцвечивать
pick	採	サイ、と-る	добывать
settle	済	サイ、す-む、す-ます, な-す, すく-う, わた-る	закончено
festival	祭	サイ、まつ-る、まつ-り	праздник
purification	斎	サイ	очищение
thin	細	サイ、ほそ-い、ほそ-る、こま-か、こま-かい	мелкий
vegetable	菜	サイ、な	овощи
most	最	サイ、もっと-も	самый
judge	裁	サイ、た-つ、さば-く	судить
bond	債	サイ	заём
sponsor	催	サイ、もよお-す	устраивать
obstruct	塞	サイ、ソク、ふさ-ぐ、ふさ-がる	затыкать
year-end	歳	サイ、（セイ）, とし, とせ	возраст
ride	載	サイ、の-せる、の-る	грузить
occasion	際	サイ、きわ	рубеж
cape (geography)	埼	キ, さき, （さい）	Сайтама
exist	在	ザイ、あ-る	находиться
lumber	材	ザイ	материал
dose	剤	ザイ	снадобье
wealth	財	ザイ、（サイ）	финансы
guilt	罪	ザイ、つみ	преступление
promontory	崎	キ, さき, みさき	мыс
make	作	サク、サ、つく-る	делать
plane	削	サク, けず-る, はつ-る, そ-ぐ	срезать
previous	昨	サク	вчера
fence	柵	サク, しがら-む	изгородь
cord	索	サク	трос
scheme	策	サク	мероприятия
vinegar	酢	サク、す	уксус
squeeze	搾	サク、しぼ-る	выжимать
confused	錯	サク, シャク	запутываться
blossom	咲	ショウ, さ-く	цвести
counter for books	冊	サツ、サク	том
tag	札	サツ、ふだ	этикетка
printing	刷	サツ、す-る, は-く	печатать
temple	刹	サツ、セツ	храм
be imminent	拶	サツ	приветствие
kill	殺	サツ、（サイ）、（セツ）、ころ-す, そ-ぐ	убивать
guess	察	サツ	инспектировать
snapshot	撮	サツ、と-る	фотографировать
grate	擦	サツ、す-る、す-れる, こす-る, こす-れる	тереть
miscellaneous	雑	ザツ、ゾウ, まじ-える, まじ-る	всякого рода
dish	皿	さら	тарелка
three	三	サン、み、み-つ、みっ-つ	три
mountain	山	サン、やま	гора
participate	参	サン、まい-る	участвовать
scaffold	桟	サン, かけはし	настил
silkworm	蚕	サン、かいこ	шелковичный червь
wretched	惨	サン、ザン、みじ-め, むご-い	трагический
give birth	産	サン, う-む, う-まれる, うぶ-, む-す	рождать
umbrella	傘	サン、かさ	зонтик
scatter	散	サン、ち-る、ち-らす、ち-らかす、ち-らかる, ばら	разбрасывать
calculate	算	サン, そろ	вычислять
acid	酸	サン、す-い	кислота
approve	賛	サン	одобрять
remainder	残	ザン、のこ-る、のこ-す	оставаться
kill by slicing	斬	ザン、き-る	отрубать
temporarily	暫	ザン, しばら-く	некоторое время
gentleman	士	シ	воин
child	子	シ、ス、こ	ребёнок
branch	支	シ, ささ-える, つか-える, か-う	филиал
stop	止	シ、と-まる、と-める, とど-める, とど-まる, や-める, や-む, よ-す, -さ-す	останавливать
family name	氏	シ、うじ	господин
do	仕	シ、（ジ）、つか-える	делать
history	史	シ	история
director	司	シ, つかさど-る	управляющий
four	四	シ、よ、よ-つ、よっ-つ、よん	четыре
market	市	シ、いち	город
arrow	矢	シ、や	стрела
delicious	旨	シ, むね, うま-い	суть
death	死	シ、し-ぬ	смерть
thread	糸	シ、いと	нить
climax	至	シ、いた-る	наиболее
pay respects	伺	シ、うかが-う	осведомляться
intention	志	シ、こころざ-す、こころざし	воля
me	私	シ、わたくし、わたし	я
use	使	シ、つか-う	употреблять
thorn	刺	シ、さ-す、さ-さる, とげ	вонзать
begin	始	シ、はじ-める、はじ-まる	начало
older sister	姉	シ、あね	старшая сестра
branch	枝	シ、えだ	ветка
welfare	祉	シ	соцобеспечение
limb	肢	シ	конечности
figure	姿	シ、すがた	фигура
think	思	シ、おも-う	думать
finger	指	シ、ゆび、さ-す	палец
carry out	施	シ、セ、ほどこ-す	осуществлять
expert	師	シ	учитель
selfish	恣	シ, ほしいまま	своеволие
paper	紙	シ、かみ	бумага
fat	脂	シ、あぶら	жир
look at	視	シ, み-る	зрение
purple	紫	シ、むらさき	фиолетовый
poetry	詞	シ	слово
tooth	歯	シ、は	зуб
heir	嗣	シ	преемник
test	試	シ、こころ-みる、ため-す	испытание
poem	詩	シ, うた	стихи
resources	資	シ	капитал
domesticate	飼	シ、か-う	выкармливать
document	誌	シ	журнал
feminine	雌	シ, め-, めす, めん	самка
seriousness	摯	シ	проникновенный
grant	賜	シ、たまわ-る, たま-う	жаловать
consult with	諮	シ、はか-る	консультироваться
indicate	示	ジ、シ、しめ-す	указывать
letter	字	ジ、あざ	иероглиф
Buddhist temple	寺	ジ、てら	храм
next	次	ジ、シ、つ-ぐ、つぎ	следующий
ear	耳	ジ、みみ	ухо
oneself	自	ジ, シ, みずか-ら, おの-ずから, おの-ずと	сам
becoming	似	ジ、に-る	похожий
child	児	ジ、（ニ）	дитя
abstract thing	事	ジ、（ズ）、こと	дело
waiter	侍	ジ、さむらい, はべ-る	самурай
govern	治	ジ、チ、おさ-める、おさ-まる、なお-る、なお-す	лечить
hold	持	ジ、も-つ, も-てる	держать
time	時	ジ、とき	время
nourishing	滋	ジ	питание
mercy	慈	ジ、いつく-しむ	привязанность
resign	辞	ジ、や-める	отставка
magnet	磁	ジ	магнит
bait	餌	ジ、えさ、え, えば	приманка
emperor's seal	璽	ジ	императорская печать
deer	鹿	ロク,しか、（か）	олень
style	式	シキ	формула
discriminating	識	シキ, し-る, しる-す	сознание
axis	軸	ジク	ось
seven	七	シチ、なな、なな-つ、（なの）	семь
scold	叱	シツ、しか-る	ругать
lose	失	シツ, うしな-う, う-せる	терять
room	室	シツ、むろ	комната
rapidly	疾	シツ, はや-い	болезнь
tenacious	執	シツ、シュウ、と-る	выполнять
damp	湿	シツ、しめ-る、しめ-す	сырой
envy	嫉	シツ, そね-む, ねた-む	ревность
lacquer	漆	シツ、うるし	лак
quality	質	シツ、シチ、（チ）, ただ-す	качество
truth	実	ジツ、み、みの-る, まこと	настоящий
turf	芝	しば	газон
copy	写	シャ、うつ-す、うつ-る	копировать
company	社	シャ, やしろ	фирма
car	車	シャ、くるま	автомобиль
cottage	舎	シャ, やど-る	здание
someone	者	シャ、もの	человек
shoot	射	シャ, い-る, さ-す	стрелять
throwaway	捨	シャ、す-てる	выбрасывать
pardon	赦	シャ	щадить
diagonal	斜	シャ, なな-め, はす	наискось
boil	煮	シャ、に-る、に-える、に-やす	варить
intercept	遮	シャ、さえぎ-る	преграждать
apologize	謝	シャ、あやま-る	благодарить
wicked	邪	ジャ, よこし-ま	дурной
snake	蛇	ジャ、ダ、へび	змея
shaku	尺	シャク	мера длины
borrow	借	シャク、か-りる	брать в долг
bartending	酌	シャク、く-む	поить сакэ
explanation	釈	シャク	пояснения
baron	爵	シャク	титул
young	若	ジャク、（ニャク）、わか-い、も-しくは, も-し	молодой
weak	弱	ジャク、よわ-い、よわ-る、よわ-まる、よわ-める	слабый
loneliness	寂	ジャク、（セキ）、さび、さび-しい、さび-れる, さみ-しい	одиночество
hand	手	シュ、て、（た）	рука
master	主	シュ、（ス）、ぬし、おも, あるじ	хозяин
protect	守	シュ、（ス）、まも-る、も-り, かみ	охранять
vermilion	朱	シュ, あけ	киноварь
take	取	シュ、と-る	брать
hunt	狩	シュ、か-る、か-り	охотиться
neck	首	シュ、くび	шея
particularly	殊	シュ、こと	особенный
pearl	珠	シュ, たま	жемчуг
alcoholic drink	酒	シュ、さけ、（さか）	сакэ
tumor	腫	シュ、は-れる、は-らす	опухоль
kind	種	シュ, たね, -ぐさ	разновидность
gist	趣	シュ, おもむき, おもむ-く	прелесть
longevity	寿	ジュ、ことぶき, ことぶ-く	долголетие
accept	受	ジュ、う-ける、う-かる	принимать
charm	呪	ジュ、のろ-う, まじな-う	проклятие
instruct	授	ジュ、さず-ける、さず-かる	предоставлять
demand	需	ジュ	спрос
Confucian	儒	ジュ	конфуцианство
trees	樹	ジュ, き	деревья
takein	収	シュウ、おさ-める、おさ-まる	доход
captured	囚	シュウ, とら-われる	арестант
state	州	シュウ、す	провинция
boat	舟	シュウ、ふね、（ふな）	лодка
excel	秀	シュウ、ひい-でる	превосходить
circumference	周	シュウ、まわ-り	кружиться
religion	宗	シュウ, ソウ, むね	религия
pickup	拾	シュウ、ジュウ、ひろ-う	подбирать
autumn	秋	シュウ、あき	осень
stinking	臭	シュウ、くさ-い、にお-う	зловоние
discipline	修	シュウ、（シュ）、おさ-める、おさ-まる	учиться
sleeve	袖	シュウ、そで	рукав
end	終	シュウ、お-わる、お-える, つい-に	конец
feel ashamed	羞	シュウ, はじ-る, は-ずかしい	смущаться
learn	習	シュウ、なら-う	учиться
week	週	シュウ	неделя
concerning	就	シュウ、（ジュ）、つ-く、つ-ける	приступать
masses	衆	シュウ、（シュ）	народ
collect	集	シュウ、あつ-まる、あつ-める、つど-う	собирать
distress	愁	シュウ、うれ-える、うれ-い	горе
repay	酬	シュウ, むく-いる	отплачивать
ugly	醜	シュウ、みにく-い	безобразный
kick	蹴	シュウ、け-る	пинать
attack	襲	シュウ, おそ-う, かさ-ね	нападать
ten	十	ジュウ、ジッ、とお、と	десять
soup	汁	ジュウ、しる, つゆ	суп
allot	充	ジュウ、あ-てる, み-たす	наполнять
dwelling	住	ジュウ、す-む、す-まう	жить
tender	柔	ジュウ、ニュウ、やわ-らか、やわ-らかい	мягкий
heavy	重	ジュウ、チョウ、え、おも-い, おも-り、かさ-ねる、かさ-なる	тяжёлый
obey	従	ジュウ、（ショウ）、（ジュ）、したが-う、したが-える	следовать
astringent	渋	ジュウ、しぶ、しぶ-い、しぶ-る	терпкий
gun	銃	ジュウ, つつ	ружьё
animal	獣	ジュウ, けもの, けだもの	зверь
vertical	縦	ジュウ、たて	вертикальный
uncle	叔	シュク	дядя
celebrate	祝	シュク、（シュウ）、いわ-う	праздновать
inn	宿	シュク、やど、やど-る、やど-す	гостиница
graceful	淑	シュク, しとやか	грациозный
solemn	粛	シュク	чистка
shrink	縮	シュク、ちぢ-む、ちぢ-まる、ちぢ-める、ちぢ-れる、ちぢ-らす	сжиматься
cram school	塾	ジュク	курсы
ripen	熟	ジュク、う-れる	спелый
exit	出	シュツ、（スイ）、で-る、だ-す, い-でる	выходить
mention	述	ジュツ、の-べる	высказывать
art	術	ジュツ, すべ	умение
genius	俊	シュン	выдающаяся личность
springtime	春	シュン、はる	весна
wink	瞬	シュン, またた-く, まじろ-ぐ	мгновение
10-day period (of the month)	旬	ジュン、（シュン）	декада
patrol	巡	ジュン、めぐ-る	патрулировать
shield	盾	ジュン、たて	щит
quasi-	准	ジュン	младший
martyrdom	殉	ジュン	самопожертвование
genuine	純	ジュン	беспримесный
sequential	循	ジュン	циркуляция
obey	順	ジュン	порядок
standard	準	ジュン, なぞら-える	неполный
wet	潤	ジュン、うるお-う、うるお-す、うる-む	влажный
abide by	遵	ジュン	соблюдать
dispose	処	ショ, ところ, -こ, お-る	распоряжаться
first	初	ショ、はじ-め、はじ-めて、はつ、うい、そ-める	первый
place	所	ショ、ところ, とこ	место
write	書	ショ、か-く	писать
commoner	庶	ショ	многочисленный
hot	暑	ショ、あつ-い	жаркий
government office	署	ショ	контора
thong	緒	ショ、（チョ）、お, いとぐち	начало
various	諸	ショ, もろ	всевозможные
woman	女	ジョ、ニョ、（ニョウ）、おんな、め	женщина
likeness	如	ジョ, ニョ, ごと-し	подобно
help	助	ジョ、たす-ける、たす-かる、すけ	спасать
preface	序	ジョ, つい-で, ついで	введение
confer	叙	ジョ	описывать
gradually	徐	ジョ, おもむ-ろに	медленно
exclude	除	ジョ、（ジ）、のぞ-く, -よ-け	устранять
small	小	ショウ、ちい-さい、こ、お	маленький
measuring box	升	ショウ、ます	мера ёмкости
few	少	ショウ、すく-ない、すこ-し	мало
summon	召	ショウ、め-す	вызывать
artisan	匠	ショウ, たくみ	мастер
bed	床	ショウ、とこ、ゆか	постель
extract	抄	ショウ	выписки
resemblance	肖	ショウ, あやか-る	сходство
esteem	尚	ショウ, なお	ещё
beckon	招	ショウ、まね-く	приглашать
acquiesce	承	ショウ、うけたまわ-る	соглашаться
riseup	昇	ショウ、のぼ-る	повышение
pine	松	ショウ、まつ	сосна
marsh	沼	ショウ、ぬま	болото
shining	昭	ショウ	эпоха Сёва
wee hours	宵	ショウ、よい	ранний вечер
leader	将	ショウ, まさ-に	генерал
extinguish	消	ショウ、き-える、け-す	гасить
symptoms	症	ショウ	синдром
auspicious	祥	ショウ, つまび-らか	добрый знак
appellation	称	ショウ, たた-える, とな-える, ほめ-る	название
laugh	笑	ショウ、わら-う、え-む	смех
chant	唱	ショウ、とな-える	распевать
sell	商	ショウ、あきな-う	коммерция
ford	渉	ショウ, わた-る	сношения
chapter	章	ショウ	эмблема
introduce	紹	ショウ	знакомить
sue	訟	ショウ	тяжба
win	勝	ショウ、か-つ、まさ-る, すぐ-れる	побеждать
manipulate	掌	ショウ, てのひら, たなごころ	ладонь
sparkle	晶	ショウ	кристалл
bake	焼	ショウ、や-く、や-ける	сжигать
char	焦	ショウ、こ-げる、こ-がす、こ-がれる、あせ-る	подгорать
nitrate	硝	ショウ	селитра
cosmetics	粧	ショウ	макияж
imperial edict	詔	ショウ、みことのり	императорский указ
evidence	証	ショウ, あかし	свидетельство
elephant	象	ショウ、ゾウ, かたど-る	явление
wound	傷	ショウ、きず、いた-む、いた-める	рана
exhort	奨	ショウ, すす-める	поощрять
illuminate	照	ショウ、て-る、て-らす、て-れる	светить
detailed	詳	ショウ, くわ-しい, つまび-らか	подробный
patent	彰	ショウ	признание заслуг
hurt	障	ショウ、さわ-る	препятствие
desire	憧	ショウ、あこが-れる	жаждать
collide	衝	ショウ, つ-く	столкновение
prize	賞	ショウ, ほ-める	награда
reparation	償	ショウ、つぐな-う	возмещать
reef	礁	ショウ	риф
bell	鐘	ショウ、かね	колокол
up	上	ジョウ、（ショウ）、うえ、（うわ）、かみ、あ-げる、あ-がる、のぼ-る、のぼ-せる、のぼ-す, よ-す	верх
length	丈	ジョウ、たけ	крепкий
superfluous	冗	ジョウ	избыточный
clause	条	ジョウ, すじ	статья
form	状	ジョウ	форма
ride	乗	ジョウ、の-る、の-せる	ехать
castle	城	ジョウ、しろ	зАмок
clean	浄	ジョウ, きよ-める, きよ-い	священный
surplus	剰	ジョウ, あまつさえ	вдобавок
normal	常	ジョウ、つね、とこ	обычный
feelings	情	ジョウ、（セイ）、なさ-け	чувство
place	場	ジョウ、ば	место
tatami mat	畳	ジョウ、たた-む、たたみ	татами
steam	蒸	ジョウ、む-す、む-れる、む-らす	варить на пару
strawrope	縄	ジョウ、なわ	верёвка
lot	壌	ジョウ	почва
lass	嬢	ジョウ, むすめ	барышня
lock	錠	ジョウ	замОк
defer	譲	ジョウ、ゆず-る	уступать
brew	醸	ジョウ、かも-す	варить пиво
color	色	ショク、シキ、いろ	цвет
wipe	拭	ショク、ふ-く、ぬぐ-う	вытирать
eat, meal	食	ショク、（ジキ）、く-う、く-らう、た-べる, は-む	еда
plant	植	ショク、う-える、う-わる	сажать
augment	殖	ショク、ふ-える、ふ-やす	приумножать
decorate	飾	ショク、かざ-る	украшать
contact	触	ショク、ふ-れる、さわ-る	трогать
entrust	嘱	ショク	поручать
weave	織	ショク、シキ、お-る	ткать
employment	職	ショク	должность
embarrass	辱	ジョク、はずかし-める	унижать
buttocks	尻	しり	зад
heart	心	シン、こころ	сердце
say	申	シン、もう-す, さる	докладывать
lengthen	伸	シン、の-びる、の-ばす、の-べる	растягивать
retainer	臣	シン、ジン	вассал
core	芯	シン	сердцевина
body	身	シン、み	тело
spicy	辛	シン、から-い, つら-い, かのと	острый на вкус
encroach	侵	シン、おか-す	вторгаться
trust	信	シン	верить
haven	津	シン、つ	гавань
god	神	シン、ジン、かみ、（かん）、（こう）	бог
lips	唇	シン、くちびる	губы
withchild	娠	シン	беременность
shake	振	シン、ふ-る、ふ-るう、ふ-れる	трястись
immersed	浸	シン、ひた-す、ひた-る	замачивать
TRUE	真	シン、ま, まこと	правда
needle	針	シン、はり	игла
deep	深	シン、ふか-い、ふか-まる、ふか-める	глубокий
sire	紳	シン	джентльмен
advance	進	シン、すす-む、すす-める	продвигаться
forest	森	シン、もり	лес
check up	診	シン、み-る	врачебный осмотр
lie down	寝	シン、ね-る、ね-かす	ложиться спать
humility	慎	シン、つつし-む	осмотрительный
new	新	シン、あたら-しい、あら-た、にい	новый
examine	審	シン, つまび-らか	разбирательство
quake	震	シン、ふる-う、ふる-える	землетрясение
fuel	薪	シン, たきぎ, まき	дрова
parent	親	シン、おや、した-しい、した-しむ	родители
person	人	ジン、ニン、ひと, -り, -と	человек
blade	刃	ジン、は, やいば	клинок
humanity	仁	ジン、（ニ）	человеколюбие
exhaust	尽	ジン、つ-くす、つ-きる、つ-かす, ことごと-く	исчерпывать
swift	迅	ジン	быстрый
tremendously	甚	ジン、はなは-だ、はなは-だしい	чрезвычайно
camp	陣	ジン	боевой порядок
inquire	尋	ジン, たず-ねる, ひろ	разыскивать
kidney	腎	ジン	почки
by all means	須	ス, すべから-く	непременно
diagram	図	ズ、ト、はか-る	чертёж
water	水	スイ、みず	вода
blow	吹	スイ、ふ-く	дуть
droop	垂	スイ、た-れる、た-らす, なんなんと-す	висеть
cook	炊	スイ、た-く	готовить пищу
commander	帥	スイ	верховное командование
chic	粋	スイ、いき	изысканный
decline	衰	スイ、おとろ-える	упадок
infer	推	スイ、お-す	предполагать
drunk	酔	スイ、よ-う	пьяный
consummate	遂	スイ, と-げる, つい-に	осуществлять
drowsy	睡	スイ	сон
ear	穂	スイ、ほ	колос
follow	随	ズイ, まにまに, したが-う	произвольный
marrow	髄	ズイ	костный мозг
hinge	枢	スウ, とぼそ	ось
adore	崇	スウ, あが-める	почитать
number	数	スウ、（ス）、かず、かぞ-える, しばしば	число
set	据	す-える、す-わる	устанавливать
cedar	杉	すぎ	криптомерия
cuff	裾	すそ	нижняя кромка
measurement	寸	スン	дюйм
rapids	瀬	せ	стремнина
just so	是	ゼ, これ, この, ここ	правильность
well	井	セイ、（ショウ）、い	колодец
world	世	セイ、セ、よ	мир
correct	正	セイ、ショウ、ただ-しい、ただ-す、まさ	правильный
life	生	セイ、ショウ、い-きる、い-かす、い-ける、う-まれる、う-む、お-う、は-える、は-やす、き、なま, な-る, な-す, む-す	жизнь
become	成	セイ、（ジョウ）、な-る、な-す	становиться
west	西	セイ、サイ、にし	запад
voice	声	セイ、（ショウ）、こえ、（こわ）	голос
control	制	セイ	система
surname	姓	セイ、ショウ	фамилия
subjugate	征	セイ	идти войной
gender	性	セイ, ショウ, さが	характер
blue	青	セイ、（ショウ）、あお、あお-い	голубой
adjusted	斉	セイ, サイ, ひと-しい	единообразие
politics	政	セイ、（ショウ）、まつりごと	политика
star	星	セイ、（ショウ）、ほし	звезда
animal sacrifice	牲	セイ	жертва
government ministry	省	セイ、ショウ、かえり-みる、はぶ-く	министерство
uncanny	凄	セイ, すご-い, すさ-まじい	ужасный
departed	逝	セイ、ゆ-く、い-く	скончаться
pure	清	セイ、（ショウ）、きよ-い、きよ-まる、きよ-める	чистый
prosper	盛	セイ、（ジョウ）、も-る、さか-る、さか-ん	процветать
bridegroom	婿	セイ、むこ	зять
clearup	晴	セイ、は-れる、は-らす	ясная погода
power	勢	セイ、いきお-い, はずみ	энергия
holy	聖	セイ, ひじり	святой
sincerity	誠	セイ、まこと	искренность
refined	精	セイ、（ショウ）	жизненная энергия
manufacture	製	セイ	изготовлять
vow	誓	セイ、ちか-う	клятва
quiet	静	セイ、（ジョウ）、しず、しず-か、しず-まる、しず-める	тихий
solicit	請	セイ、（シン）、こ-う、う-ける	просить
putinorder	整	セイ、ととの-える、ととの-う	приводить в порядок
be disillusioned 	醒	セイ, さ-ます, さ-める	пробуждать
tax	税	ゼイ	налог
evening	夕	セキ、ゆう	вечер
reject	斥	セキ, しりぞ-ける	отгонять
stone	石	セキ、（シャク）、（コク）、いし	камень
red	赤	セキ、（シャク）、あか、あか-い、あか-らむ、あか-らめる	красный
long ago	昔	セキ、（シャク）、むかし	прошлое
chop	析	セキ	анализ
seat	席	セキ, むしろ	место для сидения
stature	脊	セキ, せ, せい	позвоночник
vessels	隻	セキ	только один
pity	惜	セキ、お-しい、お-しむ	жалко
grieve	戚	セキ	родственник
blame	責	セキ、せ-める	ответственность
tracks	跡	セキ、あと	след
accumulate	積	セキ、つ-む、つ-もる	нагромождать
exploits	績	セキ	достижения
enroll	籍	セキ	приписка
cut	切	セツ、（サイ）、き-る、き-れる	резать
fold	折	セツ、お-る、おり、お-れる	сгибать
bungling	拙	セツ、つたな-い	неумелый
stealth	窃	セツ, ひそ-か	красть
contact	接	セツ、つ-ぐ	соединять
establish	設	セツ、もう-ける	учреждать
snow	雪	セツ、ゆき	снег
vicarious	摂	セツ	регент
node	節	セツ、（セチ）、ふし	сустав
theory	説	セツ、（ゼイ）、と-く	теория
tongue	舌	ゼツ、した	язык
discontinue	絶	ゼツ、た-える、た-やす、た-つ	прекращаться
thousand	千	セン、ち	тысяча
river	川	セン、かわ	река
hermit	仙	セン	маг
fortune telling	占	セン、し-める、うらな-う	завладевать
previous	先	セン, さき, ま-ず	впереди
proclaim	宣	セン, のたま-う	оглашать
specialty	専	セン、もっぱ-ら	специальный
spring	泉	セン、いずみ	родник
shallow	浅	セン、あさ-い	мелкий
wash	洗	セン、あら-う	мыть
dye	染	セン、そ-める、そ-まる、し-みる、し-み	окрашивать
fan	扇	セン、おうぎ	веер
plug	栓	セン	затычка
rotation	旋	セン	вертеться
boat	船	セン、ふね、（ふな）	судно
war	戦	セン, いくさ, たたか-う, おのの-く, そよぐ, わなな-く	война
broil	煎	セン、い-る	выпаривать
envy	羨	セン、うらや-む、うらや-ましい	зависть
gland	腺	セン	железа
discussion	詮	セン,かい	польза
tread	践	セン, ふ-む	практика
paper	箋	セン	листок бумаги
coin	銭	セン、ぜに	деньги
submerge	潜	セン、ひそ-む, ひそ-める、もぐ-る, くぐ-る	нырять
line	線	セン	линия
transition	遷	セン, うつ-る, うつ-す	перемещать
choose	選	セン、えら-ぶ	выбирать
recommend	薦	セン、すす-める	рекомендовать
slender	繊	セン	волокно
fresh	鮮	セン、あざ-やか	свежий
whole	全	ゼン、まった-く、すべ-て	полностью
in front	前	ゼン、まえ	перед
good	善	ゼン、よ-い	добро
so	然	ゼン, ネン, しか, しか-り, しか-し, さ	так
Zen	禅	ゼン	дзэн-буддизм
steadily	漸	ゼン, やや	постепенно
tray	膳	ゼン	обеденный столик
darning	繕	ゼン、つくろ-う	чинить
aim at	狙	ソ、ねら-う	целиться
thwart	阻	ソ、はば-む	задерживать
ancestor	祖	ソ	предок
tariff	租	ソ	аренда
elementary	素	ソ、ス、もと	элемент
set aside	措	ソ	откладывать
coarse	粗	ソ、あら-い	грубый
association	組	ソ、く-む、くみ	группа
alienate	疎	ソ、うと-い、うと-む, まば-ら	чуждаться
sue	訴	ソ、うった-える	жалоба
model	塑	ソ	ваять
go upstream	遡	ソ、さかのぼ-る	вверх по течению
cornerstone	礎	ソ、いしずえ	краеугольный камень
pair	双	ソウ、ふた, ならぶ	пара
robust	壮	ソウ	энергичный
early	早	ソウ、（サッ）、はや-い、はや-まる、はや-める	ранний
conflict	争	ソウ, あらそ-う, いか-でか	бороться
run	走	ソウ、はし-る	бежать
play music	奏	ソウ、かな-でる	музицировать
mutual	相	ソウ、ショウ、あい	взаимный
villa	荘	ソウ	дача
grass	草	ソウ、くさ	трава
send	送	ソウ、おく-る	посылать
warehouse	倉	ソウ、くら	амбар
search	捜	ソウ、さが-す	искать
insert	挿	ソウ, さ-す, はさ-む	вставлять
mulberry	桑	ソウ、くわ	шелковица
nest	巣	ソウ、す, す-くう	гнездо
sweep	掃	ソウ、は-く	мести
cadet	曹	ソウ	сержант
formerly	曽	ソウ、（ゾ）, かつ	пра-
refreshing	爽	ソウ、さわ-やか	освежающий
window	窓	ソウ、まど	окно
create	創	ソウ、つく-る, はじ-める, きず	творческий
miss	喪	ソウ、も	траур
get thin	痩	ソウ、や-せる	тощий
interment	葬	ソウ、ほうむ-る	похороны
attire	装	ソウ、ショウ、よそお-う	наряжаться
Buddhist priest	僧	ソウ	бонза
concept	想	ソウ, ソ, おも-う	представлять себе
stratum	層	ソウ	слой
whole	総	ソウ, すべ-て, ふさ	общий
encounter	遭	ソウ, あ-う, あ-わせる	быть застигнутым
vat	槽	ソウ, ふね	цистерна
remains	踪	ソウ	следы
maneuver	操	ソウ、みさお、あやつ-る	манипулировать
parch	燥	ソウ, はしゃ-ぐ	сохнуть
frost	霜	ソウ、しも	иней
boisterous	騒	ソウ、さわ-ぐ, さわ-がしい	шуметь
seaweed	藻	ソウ、も	водоросль
create	造	ゾウ、つく-る	изготовлять
statue	像	ゾウ	изображение
increase	増	ゾウ、ま-す、ふ-える、ふ-やす	увеличиваться
hate	憎	ゾウ、にく-む、にく-い、にく-らしい、にく-しみ	ненавидеть
warehouse	蔵	ゾウ、くら	кладовая
presents	贈	ゾウ、（ソウ）、おく-る	подарок
entrails	臓	ゾウ	внутренности
instant	即	ソク, つ-く, つ-ける, すなわ-ち	немедленно
bundle	束	ソク, たば, たば-ねる, つか, つか-ねる	пучок
foot	足	ソク、あし、た-りる、た-る、た-す	нога
stimulate	促	ソク、うなが-す	форсировать
rule	則	ソク, のっと-る	правила
breath	息	ソク、いき	дыхание
capture	捉	ソク、とら-える	ухватить
fast	速	ソク、はや-い、はや-める、はや-まる、すみ-やか	скорость
side	側	ソク, かわ, がわ, そば	сторона
fathom	測	ソク、はか-る	измерять
vulgar	俗	ゾク	житейский
tribe	族	ゾク, やから	семья
belong	属	ゾク	принадлежать
burglar	賊	ゾク	разбойник
continue	続	ゾク、つづ-く、つづ-ける	продолжаться
graduate	卒	ソツ, お-える, お-わる	солдат
rate	率	ソツ、リツ、ひき-いる	показатель
suppose	存	ソン、ゾン	существовать
village	村	ソン、むら	деревня
grandchild	孫	ソン、まご	внук
revered	尊	ソン、たっと-い、とうと-い、たっと-ぶ、とうと-ぶ	почитать
loss	損	ソン、そこ-なう、そこ-ねる	убыток
humble	遜	ソン, へりくだ-る	скромность
other	他	タ、ほか	другой
many	多	タ、おお-い	много
luxury	汰	タ	отбор
hit	打	ダ、う-つ, ぶ-つ	ударять
gentle	妥	ダ	компромисс
saliva	唾	ダ、つば, つばき	слюна
degenerate	堕	ダ, お-ちる	деградировать
lazy	惰	ダ	инерция
burdensome	駄	ダ, タ	вьюк
thick	太	タイ、タ、ふと-い、ふと-る	толстый
opposite	対	タイ、ツイ, むか-う	против
body	体	タイ、テイ、からだ	тело
resistant	耐	タイ、た-える	выдерживать
wait	待	タイ、ま-つ	ждать
neglect	怠	タイ、おこた-る、なま-ける	лень
womb	胎	タイ	зародыш
retreat	退	タイ, しりぞ-く, しりぞ-ける, ひ-く, の-く, の-ける, ど-く	отступать
sash	帯	タイ、お-びる、おび	пояс
peaceful	泰	タイ	спокойствие
piled high	堆	タイ, うずたか-い	груда
sack	袋	タイ、ふくろ	мешок
apprehend	逮	タイ	арест
exchange	替	タイ、か-える、か-わる	обмен
lend	貸	タイ、か-す	одалживать
group	隊	タイ	отряд
stagnate	滞	タイ、とどこお-る	застой
condition	態	タイ, わざ-と	состояние
be crowned with	戴	タイ	принимать
large	大	ダイ、タイ、おお、おお-きい、おお-いに	большой
substitute	代	ダイ、タイ、か-わる、か-える、よ、しろ	замещать
pedestal	台	ダイ、タイ, うてな	подставка
ordinal number prefix	第	ダイ	префикс числительных
topic	題	ダイ	тема
waterfall	滝	たき	водопад
home	宅	タク	дом
choose	択	タク, えら-ぶ	выбирать
swamp	沢	タク、さわ	болото
eminent	卓	タク	стол
clear (the land)	拓	タク, ひら-く	поднимать целину
consign	託	タク, かこつ-ける, かこ-つ	доверять
laundry	濯	タク, すす-ぐ, ゆす-ぐ	полоскать
consent	諾	ダク	согласие
voiced	濁	ダク、にご-る、にご-す	мутный
however	但	ただ-し	при условии
attain	達	タツ, -たち	достигать
undress	脱	ダツ、ぬ-ぐ、ぬ-げる	снимать
rob	奪	ダツ、うば-う	отнимать
shelf	棚	たな	полка
who (question word)	誰	スイ, だれ, たれ, た	кто
cinnabar	丹	タン	свинцовый сурик
daybreak	旦	タン、ダン	новый день
shouldering	担	タン、かつ-ぐ、にな-う	нести
simple	単	タン, ひとえ	одиночный
charcoal	炭	タン、すみ	уголь
gall bladder	胆	タン, きも	жёлчный пузырь
grope	探	タン、さぐ-る、さが-す	искать
thin	淡	タン、あわ-い	пресный
short	短	タン、みじか-い	короткий
sigh	嘆	タン、なげ-く、なげ-かわしい	вздыхать
edge	端	タン、はし、は、はた, はな	оконечность
rip	綻	タン、ほころ-びる	прореха
nativity	誕	タン	рождаться
forge	鍛	タン、きた-える	ковать
group	団	ダン、（トン）	группа
male	男	ダン、ナン、おとこ, お	мужчина
steps	段	ダン	ступень
cut off	断	ダン、た-つ、ことわ-る	прерывать
bullet	弾	ダン、たま 、ひ-く、はず-む、はじ-く, はじ-ける	пуля
warmth	暖	ダン、あたた-か、あたた-かい、あたた-まる、あたた-める	тёплый
discuss	談	ダン	разговор
podium	壇	ダン、（タン）	трибуна
ground	地	チ、ジ	земля
pond	池	チ、いけ	пруд
know	知	チ, し-る, し-らせる	знание
value	値	チ、ね、あたい	величина
shame	恥	チ、はじ、は-ずかしい、は-じる、は-じらう	стыд
(to) do	致	チ、いた-す	навлекать
slow	遅	チ、おそ-い、おく-れる、おく-らす	поздний
stupid	痴	チ, し-れる	слабоумие
immature	稚	チ, いとけない	детский
put	置	チ、お-く	класть
fine (not coarse)	緻	チ	детальный
bamboo	竹	チク、たけ	бамбук
livestock	畜	チク	скотина
pursue	逐	チク	один за другим
amass	蓄	チク、たくわ-える	запасать
fabricate	築	チク、きず-く	строительство
regularity	秩	チツ	упорядоченность
plug up	窒	チツ	удушье
tea	茶	チャ、サ	чай
wear	着	チャク、（ジャク）、き-る、き-せる、つ-く、つ-ける	прибытие
legitimate wife	嫡	チャク, テキ	законный
middle	中	チュウ, なか, うち, あた-る	середина
relationship	仲	チュウ、なか	посредник
insect	虫	チュウ、むし	насекомое
open sea	沖	チュウ、おき	открытое море
mid-air	宙	チュウ	космос
loyalty	忠	チュウ	преданность
pluck	抽	チュウ, ひき	извлекать
pour	注	チュウ, そそ-ぐ, さ-す, つ-ぐ	лить
daytime	昼	チュウ、ひる	дневное время
pillar	柱	チュウ、はしら	столб
inmost	衷	チュウ	искренние чувства
sake	酎	チュウ	сётю
casting	鋳	チュウ、い-る	отливать
stop-over	駐	チュウ	пребывать
renowned	著	チョ, チャク, あらわ-す, いちじる-しい	автор
savings	貯	チョ, た-める, たくわ-える	копить
ward	丁	チョウ、テイ, ひのと	четвёртый
condolences	弔	チョウ、とむら-う, とぶら-う	соболезновать
government office	庁	チョウ	администрация
portent, trillion	兆	チョウ、きざ-す、きざ-し	триллион
town	町	チョウ、まち	городок
long	長	チョウ, なが-い, おさ	длинный
challenge	挑	チョウ、いど-む	провоцировать
account book	帳	チョウ, とばり	книга для записей
stretch	張	チョウ、は-る	натягивать
carve	彫	チョウ、ほ-る	резьба
stare	眺	チョウ、なが-める	глядеть
angling	釣	チョウ、つ-る	удить
place on the head	頂	チョウ、いただ-く、いただき	вершина
bird	鳥	チョウ、とり	птица
morning	朝	チョウ、あさ	утро
paste	貼	チョウ、は-る	наклеивать
transcend	超	チョウ、こ-える、こ-す	сверх-
intestines	腸	チョウ, はらわた	кишечник
hop	跳	チョウ、は-ねる、と-ぶ	прыгать
indications	徴	チョウ	признак
ridicule	嘲	チョウ、あざけ-る	насмехаться
tide	潮	チョウ, しお, うしお	прилив
lucidity	澄	チョウ、す-む、す-ます	отстояться
investigate	調	チョウ、しら-べる、ととの-う、ととの-える	тон
listen	聴	チョウ、き-く, ゆる-す	слушать
penal	懲	チョウ、こ-りる、こ-らす、こ-らしめる	наказание
straight	直	チョク、ジキ、ただ-ちに、なお-す、なお-る, なお-き, す-ぐ	прямой
imperial order	勅	チョク, みことのり	императорский
make progress	捗	チョク, はかど-る	успешно идти
sink	沈	チン、しず-む、しず-める	погружаться
rare	珍	チン、めずら-しい	редкостный
majestic plural	朕	チン	императорское ''мы''
exhibit	陳	チン, ひ-ねる	излагать
fare	賃	チン	плата
tranquilize	鎮	チン、しず-める、しず-まる	усмирять
follow	追	ツイ、お-う	преследовать
oak	椎	ツイ	позвонок
crash	墜	ツイ, お-ちる, お-つ	свалиться
pass through	通	ツウ、（ツ）、とお-る、とお-す、かよ-う	проходить
pain	痛	ツウ、いた-い、いた-む、いた-める	боль
hillock	塚	つか	насыпь
pickling	漬	つ-ける、つ-かる	мариновать
two-mat area	坪	ヘイ, つぼ	цубо
claw	爪	ソウ, つめ, つま-	ноготь
crane	鶴	カク, つる	журавль
low	低	テイ、ひく-い、ひく-める、ひく-まる	низкий
display	呈	テイ	являть
courts	廷	テイ	суд
younger brother	弟	テイ、（ダイ）、（デ）、おとうと	младший брат
decide	定	テイ、ジョウ、さだ-める、さだ-まる、さだ-か	определять
bottom	底	テイ、そこ	дно
resist	抵	テイ	сопротивляться
residence	邸	テイ, やしき	особняк
pavilion	亭	テイ	ресторан
upright	貞	テイ, さだ	целомудрие
sovereign	帝	テイ, みかど	император
revise	訂	テイ	исправлять
garden	庭	テイ、にわ	двор
relay	逓	テイ	почтовая связь
halt	停	テイ, とめる, とまる	приостанавливать
spy	偵	テイ	выслеживать
dike	堤	テイ、つつみ	дамба
present	提	テイ、さ-げる	предлагать
extent	程	テイ、ほど	мера
rowboat	艇	テイ	катер
tighten	締	テイ、し-まる、し-める	затягивать
abandon	諦	テイ、あきら-める	махнуть рукой
mud	泥	デイ、どろ	грязь
target	的	テキ、まと	цель
flute	笛	テキ、ふえ	флейта
pinch	摘	テキ、つ-む	срывать
drip	滴	テキ、しずく、したた-る	капля
suitable	適	テキ	надлежащий
enemy	敵	テキ, かたき, かな-う	враг
drown	溺	デキ、おぼ-れる	тонуть
transfer	迭	テツ	чередование
philosophy	哲	テツ	философ
iron	鉄	テツ, くろがね	железо
penetrate	徹	テツ	насквозь
remove	撤	テツ	убирать
heaven	天	テン、あめ、（あま）	небо
code	典	テン	справочник
shop	店	テン, みせ, たな	магазин
point	点	テン, つ-ける, つ-く, た-てる, さ-す, とぼ-す, とも-す, ぼち	точка
expand	展	テン	выставка
annexed	添	テン、そ-える、そ-う	добавлять
revolve	転	テン、ころ-がる、ころ-げる、ころ-がす、ころ-ぶ, まろ-ぶ	поворачиваться
fill in	填	テン, はま-る, は-める, うず-める	наполнять
rice paddy	田	デン、た	рисовое поле
transmit	伝	デン、つた-わる、つた-える、つた-う	передавать
Mr.	殿	デン、テン、との、どの	дворец
electricity	電	デン	электричество
Big Dipper	斗	ト	ковш
spit	吐	ト, は-く, つ-く	изрыгать
jealousy	妬	ト、ねた-む, そね-む	ревность
junior	徒	ト, あだ	последователь
route	途	ト	путь
metropolis	都	ト、ツ、みやこ	столица
transit	渡	ト、わた-る、わた-す	переправляться
paint	塗	ト、ぬ-る, まみ-れる	намазывать
gamble	賭	ト、か-ける	азартная игра
soil	土	ド、ト、つち	земля
guy	奴	ド, やつ, やっこ	парень
toil	努	ド、つと-める	стараться
degrees	度	ド、（ト）、（タク）、たび	градус
angry	怒	ド, ヌ, いか-る, おこ-る	гнев
sword	刀	トウ, かたな, そり	катана
winter	冬	トウ, ふゆ	зима
lamp	灯	トウ, ひ, ほ-, ともしび, とも-す, あかり	лампа
hit	当	トウ、あ-たる、あ-てる, まさ-に	данный
throw	投	トウ、な-げる	бросать
beans	豆	トウ、（ズ）、まめ	боб
east	東	トウ、ひがし	восток
arrival	到	トウ	доходить
escape	逃	トウ、に-げる、に-がす、のが-す、のが-れる	убегать
overthrow	倒	トウ、たお-れる、たお-す	валиться
frozen	凍	トウ、こお-る、こご-える, い-てる, し-みる	замерзать
T'ang	唐	トウ、から	династия Тан
island	島	トウ、しま	остров
peach tree	桃	トウ、もも	персик
chastise	討	トウ、う-つ	подавлять
transparent	透	トウ、す-く、す-かす、す-ける, とう-る, とう-す	прозрачный
group	党	トウ	партия
lament	悼	トウ、いた-む	оплакивать
steal	盗	トウ、ぬす-む	красть
pottery	陶	トウ	керамика
pagoda	塔	トウ	башня
board	搭	トウ	погрузка
ridgepole	棟	トウ、むね、（むな）	конёк
hot water	湯	トウ、ゆ	горячая вода
pox	痘	トウ	оспа
climb	登	トウ、ト、のぼ-る	взбираться
answer	答	トウ、こた-える、こた-え	ответ
class	等	トウ, ひと-しい, など, -ら	равный
cylinder	筒	トウ、つつ	трубка
unite	統	トウ、す-べる	объединять
rice plant	稲	トウ、いね、（いな）	посевной рис
step	踏	トウ、ふ-む、ふ-まえる	ступать
sugar	糖	トウ	сахар
head	頭	トウ、ズ、（ト）、あたま、かしら, かぶり	голова
mimeograph	謄	トウ	копирование
wisteria	藤	トウ、ふじ	глициния
fight	闘	トウ、たたか-う	бороться
inflation	騰	トウ	рост цен
same	同	ドウ、おな-じ	одинаковый
den	洞	ドウ、ほら	пещера
trunk	胴	ドウ	туловище
move	動	ドウ、うご-く、うご-かす	двигаться
public chamber	堂	ドウ	зал
juvenile	童	ドウ、わらべ	дитя
road	道	ドウ、（トウ）、みち	дорога
work	働	ドウ、はたら-く	работать
copper	銅	ドウ, あかがね	медь
guide	導	ドウ、みちび-く	вести
pupil	瞳	ドウ、ひとみ	зрачок
mountain peak	峠	とうげ	перевал
hide	匿	トク, かくま-う	укрывать
special	特	トク	особый
acquire	得	トク、え-る、う-る	прибыль
coach	督	トク	командовать
benevolence	徳	トク	нравственность
fervent	篤	トク, あつ-い	преданный
poison	毒	ドク	яд
alone	独	ドク、ひと-り	сам
read	読	ドク、トク、（トウ）、よ-む	читать
horse chestnut	栃	（とち）	конский каштан
convex	凸	トツ, でこ	выпуклый
stab	突	トツ、つ-く	ударять
deliver	届	とど-ける、とど-く	извещение
barracks	屯	トン	военный лагерь
pork	豚	トン、ぶた	свинья
suddenly	頓	トン, とん-と, とみ-に	внезапный
covet	貪	ドン、むさぼ-る	ненасытность
dull	鈍	ドン、にぶ-い、にぶ-る, なま-る, なまく-ら	тупой
cloudy weather	曇	ドン、くも-る	пасмурный
bowl of food	丼	どんぶり、（どん）	миска
what	那	ナ	наха
what	奈	ナ, いかん	Нара
inside	内	ナイ、（ダイ）、うち	внутри
pear tree	梨	リ, なし	груша
riddle	謎	なぞ	загадка
pot	鍋	なべ	кастрюля
south	南	ナン、（ナ）、みなみ	юг
soft	軟	ナン、やわ-らか、やわ-らかい	мягкий
difficult	難	ナン、かた-い、むずか-しい, -にく-い	трудный
two	二	ニ、ふた、ふた-つ	два
nun	尼	ニ、あま	монахиня
two (falsification prevention)	弐	ニ	два
scent	匂	にお-う	запах
meat	肉	ニク, しし	мясо
rainbow	虹	コウ, にじ	радуга
day	日	ニチ、ジツ、ひ、か	день
enter	入	ニュウ、い-る、い-れる、はい-る	входить
milk	乳	ニュウ、ちち、ち	молоко
urine	尿	ニョウ	моча
responsibility	任	ニン、まか-せる、まか-す	назначение
pregnancy	妊	ニン, はら-む, みごも-る	беременная
endure	忍	ニン、しの-ぶ、しの-ばせる	ниндзя
recognize	認	ニン、みと-める, したた-める	признавать
rather	寧	ネイ, むし-ろ	вежливый
heat	熱	ネツ、あつ-い	горячий
year	年	ネン、とし	год
thought	念	ネン	мысль
twist	捻	ネン, ね-じる, ねじ-る, ひね-くる, ひね-る	закручивать
sticky	粘	ネン、ねば-る	липкий
burn	燃	ネン、も-える、も-やす、も-す	гореть
trouble	悩	ノウ、なや-む、なや-ます, なや-ましい	страдать
settlement	納	ノウ、（ナッ）、（ナ）、（ナン）、（トウ）、おさ-める、おさ-まる	уплата
ability	能	ノウ, よ-く	способность
brain	脳	ノウ	мозг
farming	農	ノウ	земледелие
concentrated	濃	ノウ、こ-い	густой
grasp	把	ハ	вязанка
wave	波	ハ、なみ	волна
sect	派	ハ	группировка
rend	破	ハ、やぶ-る、やぶ-れる	ломать
hegemony	覇	ハ	господство
horse	馬	バ、うま、（ま）	лошадь
old woman	婆	バ, ばば, ばあ	старуха
insult	罵	バ、ののし-る	бранить
worship	拝	ハイ、おが-む	поклоняться
counter for cupfuls	杯	ハイ、さかずき	чарка
back	背	ハイ、せ、せい、そむ-く、そむ-ける	спина
lungs	肺	ハイ	лёгкие
haiku	俳	ハイ	хайку
distribute	配	ハイ、くば-る	распределять
repudiate	排	ハイ	устранять
failure	敗	ハイ、やぶ-れる	поражение
abolish	廃	ハイ、すた-れる、すた-る	упразднять
comrade	輩	ハイ, -ばら, やから, ともがら	товарищ
sell	売	バイ、う-る、う-れる	продавать
double	倍	バイ	удваивать
ume (Japanese apricot)	梅	バイ、うめ	слива
cultivate	培	バイ、つちか-う	выращивать
obeisance	陪	バイ	принимать участие
mediator	媒	バイ	посредник
buy	買	バイ、か-う	покупать
compensation	賠	バイ	возмещать
white	白	ハク、ビャク、しろ、（しら）、しろ-い	белый
chief	伯	ハク	граф
clap	拍	ハク、（ヒョウ）	хлопать
overnight	泊	ハク、と-まる、と-める	ночевать
urge	迫	ハク、せま-る	наседать
peel	剥	ハク、は-がす、は-ぐ、は-がれる、は-げる, むく	обдирать
liner	舶	ハク	лайнер
Dr.	博	ハク、（バク）	эрудиция
dilute	薄	ハク、うす-い、うす-める、うす-まる、うす-らぐ、うす-ら、うす-れる, すすき	тонкий
wheat	麦	バク、むぎ	хлебные злаки
vague	漠	バク	бескрайний
truss	縛	バク、しば-る	связывать
explode	爆	バク, は-ぜる	взрыв
box	箱	はこ	ящик
chopsticks	箸	はし	палочки
farm	畑	はた、はたけ	плантация
texture	肌	はだ	кожа
eight	八	ハチ、や、や-つ、やっ-つ、（よう）	восемь
bowl	鉢	ハチ、（ハツ）	горшок
departure	発	ハツ、ホツ, た-つ	испускать
hair of the head	髪	ハツ、かみ	волосы
fell	伐	バツ, き-る, う-つ	рубить
slip out	抜	バツ、ぬ-く、ぬ-ける、ぬ-かす、ぬ-かる	вытаскивать
penalty	罰	バツ、バチ	наказывать
clique	閥	バツ	клика
anti-	反	ハン、（ホン）、（タン）、そ-る、そ-らす, かえ-す, かえ-る	против
half	半	ハン、なか-ば	половина
spread out	氾	ハン	половодье
crime	犯	ハン、おか-す	преступник
sail	帆	ハン、ほ	парус
pan-	汎	ハン	пан-
consort	伴	ハン、バン、ともな-う	сопровождать
judge	判	ハン, バン, わか-る	судить
slope	坂	ハン、さか	склон
heights	阪	ハン, さか	Осака
board	板	ハン、バン、いた	доска
printing block	版	ハン	издание
squad	班	ハン	бригада
paddy-ridge	畔	ハン, あぜ, くろ, ほとり	прибрежье
generally	般	ハン	категория
marketing	販	ハン	сбывать
blemish	斑	ハン, ふ, まだら	пятно
meal	飯	ハン、めし	варёный рис
conveyor	搬	ハン	перевозить
anxiety	煩	ハン、（ボン）、わずら-う、わずら-わす	заботы
partition	頒	ハン	раздавать
pattern	範	ハン	образец
luxuriant	繁	ハン, しげ-る, しげ-く	разрастаться
clan	藩	ハン	клан
nightfall	晩	バン	вечер
one's turn	番	バン, つが-い	черёд
barbarian	蛮	バン	дикарь
tray	盤	バン	диск
compare	比	ヒ、くら-べる	сравнивать
skin	皮	ヒ、かわ	кожа
queen	妃	ヒ, きさき	принцесса
negate	否	ヒ, いな, いや	или нет
criticism	批	ヒ	критика
he	彼	ヒ、かれ、（かの）	он
expose	披	ヒ	раскрывать
fertilizer	肥	ヒ, こ-える, こえ, こ-やす, こ-やし, ふと-る	удобрение
negative	非	ヒ, あら-ず	не
lowly	卑	ヒ、いや-しい、いや-しむ、いや-しめる	вульгарный
fly	飛	ヒ、と-ぶ、と-ばす	летать
exhausted	疲	ヒ, つか-れる,つか-らす	усталость
secret	秘	ヒ、ひ-める, ひそ-か	тайна
incur	被	ヒ, こうむ-る, おお-う, かぶ-る, かぶ-せる	подвергаться
sad	悲	ヒ、かな-しい、かな-しむ	печальный
front door	扉	ヒ、とびら	створчатая дверь
expense	費	ヒ、つい-やす、つい-える	расходы
tombstone	碑	ヒ, いしぶみ	надгробие
quit	罷	ヒ, まか-り-, や-める	забастовка
evade	避	ヒ, さ-ける, よ-ける	избегать
tail	尾	ビ、お	хвост
eyebrow	眉	ビ、（ミ）、まゆ	бровь
beauty	美	ビ, ミ, うつく-しい	красивый
provide	備	ビ, そな-える, そな-わる, つぶさ-に	приготовления
delicate	微	ビ, かす-か	мельчайший
nose	鼻	ビ、はな	нос
knee	膝	シツ, ひざ	колено
elbow	肘	チュウ, ひじ	локоть
equal	匹	ヒツ、ひき	животные
without fail	必	ヒツ、かなら-ず	обязательно
ooze	泌	ヒツ、ヒ	секреция
writing brush	筆	ヒツ、ふで	кисть
princess	姫	キ, ひめ	барышня
hundred	百	ヒャク, ビャク, もも	сто
ice	氷	ヒョウ, こおり, ひ, こお-る	лёд
express	表	ヒョウ、おもて、あらわ-す、あらわ-れる	выражать
bag	俵	ヒョウ、たわら	соломенный мешок
ballot	票	ヒョウ	голосовать
evaluate	評	ヒョウ	суждение
drift	漂	ヒョウ、ただよ-う	дрейф
signpost	標	ヒョウ, しるべ, しるし	знак
seedling	苗	ビョウ、なえ、（なわ）	рассада
second (part of time)	秒	ビョウ	секунда
sick	病	ビョウ、（ヘイ）、や-む、やまい	болеть
sketch	描	ビョウ、えが-く、か-く	рисовать
cat	猫	ビョウ、ねこ	кошка
article	品	ヒン, ホン, しな	товар
seacoast	浜	ヒン、はま	Иокогама
poor	貧	ヒン、ビン、まず-しい	бедный
V.I.P.	賓	ヒン	почётный гость
repeatedly	頻	ヒン, しき-りに	часто
cleverness	敏	ビン, さとい	проворный
flower pot	瓶	ビン, かめ	бутылка
non-	不	フ、ブ	не
husband	夫	フ, フウ, ブ, おっと, そ-れ	муж
father	父	フ、ちち	отец
attach	付	フ、つ-ける、つ-く	прикреплять
linen	布	フ、ぬの	ткань
aid	扶	フ, たす-ける	денежная поддержка
urban prefecture	府	フ	правительство
dreadful	怖	フ、こわ-い, こわ-がる, お-じる, おそ-れる	страшный
mound	阜	（フ）	Гифу
affixed	附	フ, つ-ける, つ-く	прикреплять
obituary	訃	フ	сообщение о смерти
lose	負	フ、ま-ける、ま-かす、お-う	отрицательный
proceed	赴	フ、おもむ-く	направляться
floating	浮	フ、う-く、う-かれる、う-かぶ、う-かべる	всплывать
lady	婦	フ, よめ	дама
token	符	フ	ярлык
rich	富	フ、（フウ）、と-む、とみ	богатство
universal	普	フ, あまね-く, あまねし	распространённый
rot	腐	フ、くさ-る、くさ-れる、くさ-らす	гнить
spread	敷	フ、し-く	стелить
skin	膚	フ, はだ	кожа
levy	賦	フ, ブ	взнос
musical score	譜	フ	ноты
scorn	侮	ブ, あなど-る, あなず-る	оскорблять
military	武	ブ, ム, たけ-し	военный
part	部	ブ, -べ	часть
dance	舞	ブ、ま-う、まい	танцевать
seal	封	フウ、ホウ	запечатывать
wind	風	フウ、（フ）、かぜ、（かざ）	ветер
prostrated	伏	フク、ふ-せる、ふ-す	ложиться
clothes	服	フク	одежда
vice	副	フク	вспомогательный
breadth	幅	フク、はば	ширина
again	復	フク, また	восстановление
luck	福	フク	счастье
abdomen	腹	フク、はら	живот
duplicate	複	フク	двойной
capsize	覆	フク、おお-う、くつがえ-す、くつがえ-る	покрывать
pay	払	フツ、はら-う	платить
seethe	沸	フツ、わ-く、わ-かす	кипеть
Buddha	仏	ブツ, フツ, ほとけ	Будда
thing	物	ブツ、モツ、もの	вещь
flour	粉	フン、こ、こな	порошок
distract	紛	フン、まぎ-れる、まぎ-らす、まぎ-らわす、まぎ-らわしい	беспорядочный
atmosphere	雰	フン	атмосфера
erupt	噴	フン、ふ-く	извергать
tomb	墳	フン	курган
aroused	憤	フン、いきどお-る	негодовать
stirred up	奮	フン、ふる-う	воодушевление
minute	分	ブン、フン、ブ、わ-ける、わ-かれる、わ-かる、わ-かつ	доля
writing	文	ブン, モン, ふみ, あや	литература
hear	聞	ブン、モン、き-く、き-こえる	слышать
third class	丙	ヘイ, ひのえ	третий
flat	平	ヘイ、ビョウ、たい-ら、ひら	плоский
soldier	兵	ヘイ, ヒョウ, つわもの	солдат
join	併	ヘイ、あわ-せる	вместе
line-up	並	ヘイ、なみ、なら-べる、なら-ぶ、なら-びに	выстраивать
design	柄	ヘイ, がら, え, つか	рукоятка
highness	陛	ヘイ	его Величество
closed	閉	ヘイ、と-じる、と-ざす、し-める、し-まる, た-てる	закрывать
fence	塀	ヘイ	ограда
cash	幣	ヘイ, ぬさ	валюта
abuse	弊	ヘイ	зло
cover	蔽	ヘイ, おお-う	заслонять
mochi rice cake	餅	ヘイ、もち, もちい	лепёшка
rice	米	ベイ、マイ、こめ, よね	рис
wall	壁	ヘキ、かべ	стена
sphere	璧	ヘキ, たま	драгоценный диск
mannerism	癖	ヘキ、くせ	привычка
separate	別	ベツ, わか-れる, わ-ける	отдельный
ignore	蔑	ベツ, ないがしろ, なみ-する,  さげす-む	презирать
one-sided	片	ヘン、かた	один из двух
environs	辺	ヘン, あた-り, ほと-り, -べ	окрестности
return	返	ヘン、かえ-す、かえ-る	ответ
change	変	ヘン、か-わる、か-える	меняться
partial	偏	ヘン、かたよ-る	отклонение
everywhere	遍	ヘン, あまね-く	вездесущий
compile	編	ヘン、あ-む	вязать
valve	弁	ベン, ヘン, わきま-える, わ-ける, はなびら	речь
convenience	便	ベン、ビン、たよ-り	почта
exertion	勉	ベン, つと-める	прилежный
walk	歩	ホ、ブ、（フ）、ある-く、あゆ-む	ходить
preserve	保	ホ, ホウ, たも-つ	сохранять
suckle	哺	ホ	вскармливать
catch	捕	ホ、と-らえる、と-らわれる、と-る、つか-まえる、つか-まる	хватать
supplement	補	ホ、おぎな-う	восполнять
pavement	舗	ホ	мостить
mother	母	ボ、はは	мать
recruit	募	ボ、つの-る	вербовать
grave	墓	ボ、はか	могила
pining	慕	ボ、した-う	обожать
livelihood	暮	ボ、く-れる、く-らす	сумерки
register	簿	ボ	конторская книга
direction	方	ホウ、かた	сторона
wrap	包	ホウ、つつ-む, くる-む	обёртывать
perfume	芳	ホウ、かんば-しい	душистый
home country	邦	ホウ, くに	родная страна
observance	奉	ホウ、（ブ）、たてまつ-る, まつ-る	преподносить
treasure	宝	ホウ、たから	сокровище
embrace	抱	ホウ、だ-く、いだ-く、かか-える	обхватывать
release	放	ホウ、はな-す、はな-つ、はな-れる、ほう-る	отпускать
method	法	ホウ、（ハッ）、（ホッ）	закон
bubbles	泡	ホウ、あわ	пена
placenta	胞	ホウ	плацента
salary	俸	ホウ	жалованье
emulate	倣	ホウ、なら-う	подражать
summit	峰	ホウ、みね	вершина
cannon	砲	ホウ	пушка
crumble	崩	ホウ、くず-れる、くず-す	рушиться
visit	訪	ホウ、おとず-れる、たず-ねる, と-う	посещать
report	報	ホウ、むく-いる	информация
bee	蜂	ホウ、はち	пчела
bountiful	豊	ホウ、ゆた-か, とよ	обильный
sated	飽	ホウ、あ-きる、あ-かす, あ-く	приедаться
praise	褒	ホウ、ほ-める	хвалить
sew	縫	ホウ、ぬ-う	шить
deceased	亡	ボウ、（モウ）、な-い, ほろ-びる, ほろ-ぶ, ほろ-ぼす	покойный
scarce	乏	ボウ, とぼ-しい, とも-しい	скудный
busy	忙	ボウ、いそが-しい, せわ-しい	занятой
boy	坊	ボウ、（ボッ）	мальчик
disturb	妨	ボウ、さまた-げる	препятствовать
forget	忘	ボウ、わす-れる	забывать
prevent	防	ボウ、ふせ-ぐ	предотвращать
tassel	房	ボウ、ふさ	камера
obese	肪	ボウ	жир
so-and-so	某	ボウ, それがし, なにがし	некий
risk	冒	ボウ、おか-す	отважиться
divide	剖	ボウ	вскрытие
spinning	紡	ボウ、つむ-ぐ	прясть
hope	望	ボウ、モウ、のぞ-む, もち	надеяться
bystander	傍	ボウ、かたわ-ら, わき, おか-, はた, そば	сбоку
cap	帽	ボウ	головной убор
rod	棒	ボウ	палка
trade	貿	ボウ	торговля
appearance	貌	ボウ, かたち	внешность
outburst	暴	ボウ、（バク）、あば-く、あば-れる	насилие
swell	膨	ボウ、ふく-らむ、ふく-れる	разбухать
conspire	謀	ボウ、（ム）、はか-る, たばか-る, はかりごと	замышлять
cheek	頬	ほお, ほほ	щека
north	北	ホク、きた	север
tree	木	ボク、モク、き、（こ）	дерево
crude	朴	ボク, ほお, えのき	простодушный
breed	牧	ボク、まき	пасти
harmonious	睦	ボク, むつ-まじい, むつ-む, むつ-ぶ	дружный
me	僕	ボク, しもべ	я
black ink	墨	ボク、すみ	тушь
slap	撲	ボク	побои
drown	没	ボツ, モツ	скрываться из виду
rise	勃	ボツ	быстрый подъём
ditch	堀	ほり	канал
book	本	ホン、もと	книга
bustle	奔	ホン, はし-る	беготня
flip	翻	ホン、ひるがえ-る、ひるがえ-す	перелагать
mediocre	凡	ボン、（ハン）, およ-そ, すべ-て	посредственный
basin	盆	ボン	поднос
hemp	麻	マ、あさ	конопля
chafe	摩	マ, ま-する, さ-する, す-る	трение
grind	磨	マ, みが-く, す-る	шлифовать
witch	魔	マ	демон
every	毎	マイ, ごと, -ごと-に	каждый
younger sister	妹	マイ、いもうと	младшая сестра
sheet of...	枚	マイ	плоские предметы
foolish	昧	マイ	невежественный
bury	埋	マイ, う-める, う-まる, う-もれる, うず-める, うず-まる, い-ける	зарывать
curtain	幕	マク、バク	занавес
membrane	膜	マク	перепонка
pillow	枕	チン, まくら	подушка
or again	又	また	опять
end	末	マツ、バツ、すえ	окончание
rub	抹	マツ	растирать
ten thousand	万	マン, バン, よろず	десять тысяч
full	満	マン、み-ちる、み-たす, み-つ	полный
ridicule	慢	マン	высокомерный
cartoon	漫	マン	бесцельный
not yet	未	ミ, いま-だ, ま-だ, ひつじ	ещё не
flavor	味	ミ、あじ、あじ-わう	вкус
fascination	魅	ミ	очаровывать
headland	岬	みさき	мыс
secrecy	密	ミツ, ひそ-か	тайна
honey	蜜	ミツ	мёд
vein	脈	ミャク	жила
exquisite	妙	ミョウ, ビョウ, たえ	чудесный
people	民	ミン、たみ	народ
sleep	眠	ミン、ねむ-る、ねむ-い	спать
halberd	矛	ム、ほこ	копьё
duty	務	ム、つと-める、つと-まる	дела
nothing	無	ム、ブ、な-い	без
dream	夢	ム、ゆめ	сновидение
fog	霧	ム、きり	туман
daughter	娘	むすめ	дочь
name	名	メイ、ミョウ、な	имя
fate	命	メイ、ミョウ、いのち	приказ
bright	明	メイ、ミョウ、あ-かり、あか-るい、あか-るむ、あか-らむ、あき-らか、あ-ける、あ-く、あ-くる、あ-かす	ясный
astray	迷	メイ、まよ-う	заблудиться
dark	冥	メイ、ミョウ	потусторонний
alliance	盟	メイ	союз
inscription	銘	メイ	надпись
chirp	鳴	メイ、な-く、な-る、な-らす	чирикать
destroy	滅	メツ, ほろ-びる, ほろ-ぶ, ほろ-ぼす	гибнуть
excuse	免	メン, まぬか-れる, まぬが-れる	освобождать
face	面	メン、おも、おもて、つら	лицо
cotton	綿	メン、わた	хлопок
noodles	麺	メン	лапша
overgrown	茂	モ、しげ-る	густо расти
imitation	模	モ、ボ	образец
hair	毛	モウ、け	шерсть
delusion	妄	モウ、ボウ	вздор
blind	盲	モウ, めくら	слепой
decrease	耗	モウ、（コウ）	убыль
fierce	猛	モウ	свирепый
netting	網	モウ、あみ	сеть
eye	目	モク、（ボク）、め、（ま）	глаз
silence	黙	モク、だま-る	молчать
gates	門	モン、かど	ворота
family crest	紋	モン	герб
question	問	モン、と-う、と-い、（とん）	вопрос
melting	冶	ヤ	металлургия
night	夜	ヤ、よ、よる	ночь
field	野	ヤ、の	поле
all the more	弥	ミ, ビ, いや, や	ещё больше
unlucky	厄	ヤク	несчастье
service	役	ヤク、エキ	роль
promise	約	ヤク	приблизительно
translate	訳	ヤク、わけ	перевод
medicine	薬	ヤク、くすり	лекарство
leap	躍	ヤク、おど-る	скакать
darkness	闇	やみ, くら-い	чёрный рынок
reason	由	ユ、ユウ、（ユイ）、よし, よ-る	причина
oil	油	ユ、あぶら	масло
metaphor	喩	ユ, たと-える	метафора
pleasure	愉	ユ, たの-しい	приятный
rebuke	諭	ユ、さと-す	увещевать
transport	輸	ユ, シュ	ввоз-вывоз
healing	癒	ユ、い-える、い-やす	заживать
solely	唯	ユイ、（イ）, ただ	только
friend	友	ユウ、とも	друг
have	有	ユウ、ウ、あ-る	иметь
courage	勇	ユウ、いさ-む	храбрость
seclude	幽	ユウ, かす-か	потусторонний
permanence	悠	ユウ	неторопливый
mail	郵	ユウ	почта
boil	湧	ユウ、わ-く	бить фонтаном
furthermore	猶	ユウ, ユ, なお	еврей
abundant	裕	ユウ	достаток
play	遊	ユウ、（ユ）、あそ-ぶ, あそ-ばす	развлекаться
male	雄	ユウ, お-, おす, おん	самец
entice	誘	ユウ、さそ-う, いざな-う	завлекать
melancholy	憂	ユウ、うれ-える、うれ-い、う-い	беспокойство
dissolve	融	ユウ, と-ける, と-かす	финансы
superior	優	ユウ、やさ-しい、すぐ-れる, まさ-る	превосходный
give	与	ヨ、あた-える, あずか-る, くみ-する	давать
in advance	予	ヨ, あらかじ-め	заранее
leave over	余	ヨ、あま-る、あま-す, あんま-り	излишек
reputation	誉	ヨ、ほま-れ, ほ-める	честь
deposit	預	ヨ、あず-ける、あず-かる	депозит
infancy	幼	ヨウ、おさな-い	младенец
use	用	ヨウ、もち-いる	употреблять
sheep	羊	ヨウ、ひつじ	овца
bewitching	妖	ヨウ、あや-しい	волшебный
ocean	洋	ヨウ	океан
need	要	ヨウ、かなめ、い-る	требоваться
contain	容	ヨウ, い-れる	вмещать
commonplace	庸	ヨウ	заурядный
hoist	揚	ヨウ、あ-げる、あ-がる	поднимать
swing	揺	ヨウ、ゆ-れる、ゆ-る、ゆ-らぐ、ゆ-るぐ、ゆ-する、ゆ-さぶる、ゆ-すぶる	трястись
leaf	葉	ヨウ、は	листва
sunshine	陽	ヨウ, ひ	солнце
melt	溶	ヨウ、と-ける、と-かす、と-く	растворяться
loins	腰	ヨウ、こし	поясница
formal title	様	ヨウ、さま	вот так
boil (medical)	瘍	ヨウ	язва
jump	踊	ヨウ、おど-る、おど-り	плясать
kiln	窯	ヨウ、かま	печь для обжига
foster	養	ヨウ、やしな-う	вскармливать
embrace	擁	ヨウ	поддерживать
noh chanting	謡	ヨウ、うたい、うた-う	народная песня
day of the week	曜	ヨウ	день недели
repress	抑	ヨク、おさ-える	сдерживать
fertility	沃	ヨウ, ヨク	йод
bathe	浴	ヨク、あ-びる、あ-びせる	купаться
longing	欲	ヨク、ほっ-する、ほ-しい	желать
the following	翌	ヨク	следующий день
wing	翼	ヨク、つばさ	крыло
crush	拉	ラ, ひし-ぐ	раздавить
naked	裸	ラ、はだか	голый
gauze	羅	ラ, うすもの	тонкий шёлк
come	来	ライ、く-る、きた-る、きた-す	приходить
thunder	雷	ライ、かみなり, いかずち, いかづち	гром
trust	頼	ライ、たの-む、たの-もしい、たよ-る	просить
entwine	絡	ラク、から-む、から-まる、から-める	зацепляться
fall	落	ラク、お-ちる、お-とす	падать
dairy products	酪	ラク	молокопродукты
bitter	辣	ラツ	горький
riot	乱	ラン、みだ-れる、みだ-す	беспорядок
egg	卵	ラン、たまご	яйцо
perusal	覧	ラン	осматривать
excessive	濫	ラン, みだ-りに, みだ-りがましい	превышение
indigo	藍	ラン、あい	индиго
column	欄	ラン	столбец
officer	吏	リ	чиновник
profit	利	リ、き-く	выгода
village	里	リ、さと	родная деревня
reason	理	リ, ことわり	принцип
diarrhea	痢	リ	понос
back	裏	リ、うら	изнанка
footgear	履	リ、は-く	осуществлять
glassy	璃	リ	ляпис-лазурь
detach	離	リ、はな-れる、はな-す	отделяться
land	陸	リク, ロク, おか	суша
stand up	立	リツ、（リュウ）、た-つ、た-てる	стоять
law	律	リツ、（リチ）	ритм
fear	慄	リツ	содрогаться
abbreviation	略	リャク, ほぼ	сокращение
willow	柳	リュウ、やなぎ	плакучая ива
stream	流	リュウ、（ル）、なが-れる、なが-す	течение
detain	留	リュウ、（ル）、と-める、と-まる, とど-める, とど-まる	пребывать
dragon	竜	リュウ、たつ	дракон
grains	粒	リュウ、つぶ	частица
hump	隆	リュウ	процветать
sulphur	硫	リュウ	сера
companion	侶	リョ, とも	товарищ
trip	旅	リョ、たび	путешествие
captive	虜	リョ, とりこ	пленный
prudence	慮	リョ, おもんぱく-る, おもんぱか-る	размышлять
finish	了	リョウ	понимать
both	両	リョウ	оба
good	良	リョウ、よ-い,  い-い	хороший
fee	料	リョウ	плата
refreshing	涼	リョウ、すず-しい、すず-む, すずやか	прохладный
game-hunting	猟	リョウ, か-る	охота
mausoleum	陵	リョウ、みささぎ	усыпальница
quantity	量	リョウ、はか-る	количество
colleague	僚	リョウ	коллега
territory	領	リョウ, えり	территория
dormitory	寮	リョウ	общежитие
heal	療	リョウ	лечение
clear	瞭	リョウ	очевидный
provisions	糧	リョウ、（ロウ）、かて	продовольствие
power	力	リョク、リキ、ちから	сила
green	緑	リョク、（ロク）、みどり	зелёный
woods	林	リン、はやし	лес
thousandth	厘	リン	самая малость
ethics	倫	リン	мораль
wheel	輪	リン、わ	колесо
neighboring	隣	リン、とな-る、となり	соседний
look to	臨	リン、のぞ-む	присутствовать
lapis lazuli	瑠	ル	ляпис-лазурь
tears	涙	ルイ、なみだ	слёзы
accumulate	累	ルイ	накапливаться
bases	塁	ルイ, とりで	крепостной вал
sort	類	ルイ、たぐ-い	сорт
orders	令	レイ	приказ
thanks	礼	レイ、ライ	этикет
cool	冷	レイ、つめ-たい、ひ-える、ひ-や、ひ-やす、ひ-やかす、ひややか, さ-める、さ-ます	холодный
encourage	励	レイ、はげ-む、はげ-ます	побуждать
re-	戻	レイ、もど-す、もど-る	возвращать
example	例	レイ、たと-える	пример
small bell	鈴	レイ、リン、すず	колокольчик
zero	零	レイ, ぜろ, こぼ-す, こぼ-れる	ноль
spirits	霊	レイ、リョウ、たま	дух
slave	隷	レイ	раб
age	齢	レイ, よわい	возраст
lovely	麗	レイ, うるわ-しい, うら-らか	прекрасный
calendar	暦	レキ、こよみ	календарь
curriculum	歴	レキ	карьера
row	列	レツ	ряд
inferiority	劣	レツ、おと-る	хуже
ardent	烈	レツ, はげ-しい	яростный
split	裂	レツ、さ-く、さ-ける	рваться
romance	恋	レン、こ-う、こい、こい-しい	любовь
take along	連	レン、つら-なる、つら-ねる、つ-れる	связь
bargain	廉	レン	неподкупный
practice	練	レン、ね-る	тренироваться
tempering	錬	レン, ね-る	закалять
spine	呂	ロ, リョ	ванна
hearth	炉	ロ	печь
bribe	賂	ロ, まいな-い, まいな-う	взятка
road	路	ロ、じ, みち	дорога
dew	露	ロ、（ロウ）、つゆ	роса
old man	老	ロウ、お-いる、ふ-ける	старик
labour	労	ロウ, いたわ-る, いた-ずき, ねぎら-う	труд
tamper with	弄	ロウ、もてあそ-ぶ, いじく-る, いじ-る	забавляться
son	郎	ロウ	молодой человек
melodious	朗	ロウ、ほが-らか	звучный
wandering	浪	ロウ	бродить
corridor	廊	ロウ	коридор
watchtower	楼	ロウ	высокое здание
leak	漏	ロウ、も-る、も-れる、も-らす	протекать
basket	籠	ロウ、かご、こ-もる, こ-める, こ-む	корзина
six	六	ロク、む、む-つ、むっ-つ、（むい）	шесть
record	録	ロク	запись
foot of a mountain	麓	ロク、ふもと	подножие горы
theory	論	ロン	теория
peace	和	ワ、（オ）、やわ-らぐ、やわ-らげる、なご-む、なご-やか	гармония
talk	話	ワ、はな-す、はなし	говорить
bribe	賄	ワイ、まかな-う	поставлять
aside	脇	わき	бок туловища
beguile	惑	ワク、まど-う	растерянность
frame	枠	わく	рамка
gulf	湾	ワン	залив
arm	腕	ワン、うで	рука